paradisaical: paradisiacal 
caravansaries: caravanserais 
caracas: cascara 
paradisaic: paradisiac 
anacolutha: talcahuano 
maracas: mascara 
analysand: nyasaland 
armadas: madrasa 
apanage: pangaea 
australian: saturnalia 
samaritan: sarmatian 
asmara: samara 
sabbath: shabbat 
broadcasters: rebroadcasts 
broadcaster: rebroadcast 
backwards: drawbacks 
backward: drawback 
bacterial: calibrate 
flashback: halfbacks 
fastback: fatbacks 
bargained: gabardine 
hairbreadths: hairsbreadth 
abstained: bastinade 
bastardies: bastardise 
ablated: datable 
broadtail: tailboard 
labrador: larboard 
aboard: abroad baroda 
releasable: resealable 
alterable: relatable 
saleable: sealable 
amenable: nameable 
banalities: insatiable 
arable: arbela 
abeam: ameba 
bahai: bahia 
habitat: tabitha 
abash: sabah 
tabulations: tabulations 
basilan: basinal 
swabia: wasabi 
alba: baal 
alban: banal 
balsa: basal 
basalt: tablas 
bantams: batsman 
bantam: batman 
basra: sabra 
carcinoma: macaronic 
carcinomas: macaronics 
accruals: caraculs 
accrual: caracul 
staccato: toccatas 
adjudications: adjudications 
demarcate: macerated 
catalogued: coagulated 
caledonia: laodicean 
demarcations: demarcations 
advances: canvased 
arcading: cardigan 
candia: dacian 
antiallergic: interglacial 
analgesic: angelicas 
catalogues: coagulates 
catalogue: coagulate 
empathically: emphatically 
psychoanalyses: psychoanalyses 
antiparticles: paternalistic 
cartesianism: sectarianism 
inactivate: vaticinate 
alliance: canaille 
conservational: conversational 
valencia: valiance 
cavaliers: cavalries 
canaries: cesarian 
ascertains: sectarians 
ascertain: cartesian sectarian 
avarices: caviares 
avarice: caviare 
capella: laplace 
ancestral: lancaster 
catalyses: catalyses 
caveats: vacates 
caveat: vacate 
antifascism: fanaticisms 
flatcars: fractals 
flatcar: fractal 
cataloguing: coagulating 
algorithmically: logarithmically 
calligraphy: graphically 
chairmanships: chairmanships 
harmonicas: maraschino 
archaism: charisma 
archaisms: charismas 
anaphoric: pharaonic 
aphasic: chiapas 
archaists: catharsis 
misapplications: misapplications 
inactivation: vaticination 
capillarity: piratically 
racialist: satirical 
activations: vacationist 
activation: cavitation 
allocation: locational 
coattails: tailcoats 
coattail: tailcoat 
alaric: racial 
rascality: sacrality 
calais: scalia 
caiman: maniac 
macaroni: marciano 
caimans: maniacs 
croatian: raincoat 
octavian: vacation 
arnica: carina crania 
casually: causally 
capsular: scapular 
carla: clara 
lascar: rascal sacral scalar 
calvary: cavalry 
casual: causal 
capstan: catnaps 
actuators: autocrats 
actuator: autocrat 
devaluate: evaluated 
paederast: separated 
adulterating: triangulated 
drainage: gardenia 
drainages: gardenias 
headlamps: lampshade 
idealizations: idealizations 
desalination: nationalised 
derivational: revalidation 
almandite: laminated 
salivated: validates 
madeiran: marinade 
animadverts: maidservant 
animated: diamante 
appraised: disappear 
aspirated: disparate 
andean: deanna 
andante: dantean 
adapter: readapt 
farmlands: farmlands 
grasslands: grasslands 
grandam: grandma 
grandams: grandmas 
marshlands: marshlands 
altitudinal: latitudinal 
adulation: laudation 
diana: nadia naiad 
adrian: radian 
dakar: kadar 
landau: luanda 
adulatory: laudatory 
damnatory: mandatory 
maynard: yardman 
dramas: madras 
madura: maraud 
greasepaint: pageantries 
managements: managements 
amphitheaters: amphitheatres 
amphitheater: amphitheatre 
emanates: manatees 
emanate: enemata manatee 
fantasies: fantasise 
plagiaries: plagiarise 
algeria: regalia 
angela: galena 
galenas: lasagne 
lavages: salvage 
managers: semarang 
magentas: magnates 
magenta: magnate 
ravages: savager 
assuages: sausages 
assuage: sausage 
gateways: getaways 
agaves: savage 
gateway: getaway 
serializations: serializations 
alienations: nationalise 
rationalises: realisations 
rationalise: realisation 
aristotelian: retaliations 
rationalizes: realizations realizations 
rationalize: realization 
repatriations: repatriations 
parliaments: paternalism 
rationales: senatorial 
alienator: rationale 
assailer: salaries 
aestival: salivate 
armenian: marianne 
amnesia: anemias 
praetorian: reparation 
rainwaters: warranties 
antisera: artesian santeria 
aspirates: parasites 
aspirate: parasite 
paternally: prenatally 
paellas: paellas 
parental: paternal prenatal 
relaxants: transaxle 
parmesan: spearman 
eastman: smetana 
apnea: paean 
anapests: peasants 
anapest: peasant 
affair: raffia 
affairs: raffias 
armagh: graham 
alarmingly: marginally 
alarming: marginal 
galvani: vaginal 
antagonism: montagnais 
antagonists: stagnations 
antagonist: stagnation 
arraigns: srinagar 
assaying: gainsays 
guiana: iguana 
agita: taiga 
alga: gala 
analog: angola 
arugula: augural 
gamma: magma 
gammas: magmas 
angora: aragon 
arrogant: tarragon 
agar: agra raga 
agars: ragas 
aah: aha 
hanuka: kahuna 
allah: halal 
amah: hama 
ashram: marsha 
visualizations: visualizations 
laminations: nationalism 
antimonial: lamination 
impartial: primatial 
juanita: tijuana 
laminal: manilla 
maritally: martially 
lamaism: miasmal 
animal: lamina malian manila 
animals: laminas manilas 
marital: martial 
lanai: liana 
notarial: rational 
atonalist: saltation 
antlia: latina 
latvian: valiant 
aquila: qualia 
altair: atrial lariat 
avails: saliva salvia 
amain: amnia mania 
maturation: natatorium 
airman: marian marina 
manias: samian 
mantissas: satanisms 
mantissa: satanism staminas 
arizona: azorian 
parian: pirana 
aspirants: partisans 
aspirant: partisan 
patinas: pinatas 
patina: pinata 
artisans: tsarinas 
artisan: sinatra tsarina 
assistant: satanists 
atria: tiara 
ajar: raja 
karla: kraal 
karma: marka 
arak: kara 
alma: lama 
anomaly: layamon 
alumna: manual 
alarm: lamar marla 
alan: anal lana 
appal: papal 
palau: paula 
altars: astral tarsal 
aural: laura 
alva: lava 
annam: manna 
manaos: samoan 
mantas: tasman 
atman: manat manta 
mara: rama 
sumatra: traumas 
marat: marta 
anna: naan 
rattans: tantras tartans 
rattan: tantra tartan 
nassau: saunas 
santa: satan 
ostrava: saratov 
satrap: sparta 
pasta: tapas 
saar: sara 
attars: strata 
attar: tatar tatra 
babbled: blabbed 
babbler: blabber 
babblers: blabbers 
babbling: blabbing 
dabbles: slabbed 
barbed: dabber 
abbe: babe 
babier: barbie 
babiest: tabbies 
barbel: rabble 
barbels: rabbles 
absorber: reabsorb 
rabbets: stabber 
abbes: babes 
abby: baby 
acerbic: breccia 
cambered: embraced 
ascribed: carbides 
receivables: serviceable 
certifiable: rectifiable 
cambering: embracing 
alembic: cembali 
caliber: calibre 
calibers: calibres 
ascribe: brescia 
abscise: scabies 
bookcase: casebook 
bookcases: casebooks 
backswept: sweptback 
backrest: brackets 
cable: caleb 
clambers: scramble 
acerb: brace caber 
braces: cabers 
obfuscations: obfuscations 
blackings: slingback 
obscurantist: subtractions 
bucksaws: sawbucks 
bucksaw: sawbuck 
carob: cobra 
carobs: carobs cobras 
carbs: crabs 
cabs: scab 
bad: dab 
bearded: breaded 
abided: baddie 
balded: bladed 
boarded: roadbed 
adsorbed: roadbeds 
abed: bade bead 
beavered: bereaved 
beadiest: diabetes 
banderole: bandoleer 
bandoleers: endorsable 
belated: bleated 
breasted: debaters 
berated: debater rebated 
bearding: breading 
beadings: debasing 
abridge: brigade 
abridges: brigades 
bondage: dogbane 
badger: barged garbed 
abhorred: harbored 
bipedal: piebald 
baldies: disable 
bandier: brained 
brandeis: brandies 
abider: airbed 
airbeds: braised seabird sidebar 
seabirds: sidebars 
abides: biased 
barked: braked debark 
baled: blade 
ambled: bedlam beldam blamed lambed 
marbled: rambled 
albedo: doable 
balder: blared 
brawled: warbled 
baldest: blasted stabled 
bermuda: rumbaed 
bander: brenda 
bernard: brander 
abode: adobe 
boarder: broader 
abodes: adobes 
bared: beard bread breda debar debra 
beards: breads debars 
daubers: earbuds 
dauber: earbud 
adverb: braved 
based: beads 
bayed: beady 
balding: blading 
adsorbing: boardings signboard 
bridal: ribald 
braid: rabid 
braids: disbar 
badly: baldy 
dunbar: durban 
board: broad dobra 
adsorb: boards broads 
bard: brad drab 
bards: brads drabs 
bads: dabs 
bauds: daubs 
baud: daub 
beavering: bereaving 
establisher: reestablish 
leviable: liveable 
balinese: baseline 
beastlier: bleariest liberates 
revisable: verbalise 
avertible: veritable 
seizable: sizeable 
brasserie: brassiere 
brasseries: brassieres 
barkeep: prebake 
labeler: relabel 
baleen: enable 
baleens: enables 
seatbelt: testable 
barrettes: batterers 
barrette: batterer 
betrayer: teaberry 
beaters: berates rebates 
beater: berate rebate 
fiberglass: fibreglass 
tablespoonfuls: tablespoonsful 
bagger: beggar 
algenib: belgian bengali 
bleating: tangible 
berating: rebating 
bagel: gable 
gambler: gambrel 
bangle: bengal 
bagels: gables 
bogeyman: moneybag 
behaviorisms: misbehaviors 
behaviourism: misbehaviour 
behaviorism: misbehavior 
banishes: banshies 
behaviours: behaviours 
behaviors: behaviors 
blather: halbert 
boathouses: houseboats 
boathouse: houseboat 
abhorrer: harborer 
brahe: rehab 
basher: rehabs 
barthes: bathers breaths 
bather: bertha breath 
bathes: shebat 
instabilities: instabilities 
binaries: siberian 
labile: liable 
braille: liberal 
ballsier: brailles liberals 
bareilly: blearily reliably 
bimetal: timbale 
abseil: isabel 
ableist: bastile bestial stabile 
probationers: reabsorption 
probationer: reprobation 
baritone: obtainer 
botanies: obeisant 
arbiters: rarebits 
arbiter: rarebit 
bizarre: brazier 
braise: rabies 
bestiary: sybarite 
baiter: barite 
battier: biretta 
bake: beak 
basketworks: workbaskets 
basketwork: workbasket 
blake: bleak 
blankest: blankets 
breakouts: outbreaks 
breakout: outbreak 
baker: brake break 
bakers: brakes breaks 
bakes: beaks 
abel: able bale elba 
bella: label 
amble: blame mabel melba 
albumens: bluesman 
ambler: marble ramble 
amblers: marbles rambles 
ambles: blames 
subaltern: unstabler 
nebula: unable 
bloater: retablo 
boatel: lobate oblate 
abler: baler blare blear 
brawlers: warblers 
brawler: warbler 
balers: blares 
blaster: stabler 
albert: labret 
bawler: warble 
barely: barley bleary 
bales: basel basle blase sable 
ablest: bleats stable tables 
battles: tablets 
basely: belays 
bleat: table 
battle: tablet 
amber: bream 
ambers: breams 
bane: bean eban 
banter: barnet 
barney: nearby 
banes: beans 
boaster: boaters 
boater: borate 
barque: braque 
bare: bear brae 
barer: barre berra 
bares: baser bears braes saber sabre 
sabers: sabres 
basters: breasts 
barest: baster breast 
abuser: bursae 
brazes: zebras 
braze: zebra 
basest: basset bastes beasts 
abets: baste bates beast beats betas 
abuse: beaus 
abet: bate beat beta 
bagfuls: bagsful 
bag: gab 
barging: garbing 
abhorring: harboring 
barking: braking 
ambling: blaming lambing 
marbling: rambling 
marblings: ramblings 
brawling: warbling 
blasting: stabling 
boasting: boatings 
bangui: ubangi 
bangor: brogan 
bogota: tobago 
brag: garb grab 
brags: garbs grabs 
bags: gabs 
brinkmanships: brinksmanship 
bhutan: thuban 
bahts: baths 
baht: bath 
abolitionism: mobilisation 
lambkins: lambskin 
bail: bali 
albino: albion 
bipolar: parboil 
bailout: tabouli 
arbil: blair libra 
bails: basil 
baptism: bitmaps 
barium: umbria 
absorption: probations 
bonsai: bosnia 
bastion: obtains 
bonita: obtain 
bairn: brain brian rabin 
bairns: brains 
binary: brainy 
basin: sabin 
bari: rabi 
basis: bassi 
balk: kalb 
baulk: kabul 
alb: lab 
balm: lamb 
lumbar: umbral 
balms: lambs 
labor: lobar 
albs: labs slab 
barnum: burman 
rumbas: umbras 
burma: rumba umbra 
ban: nab 
barony: baryon 
barn: bran 
barns: brans 
unbar: urban 
bans: nabs 
aborts: tabors 
brasov: bravos 
abort: tabor 
rubato: tabour 
boasts: sabots 
boast: boats sabot 
arb: bar bra 
bars: bras 
bart: brat 
basts: stabs 
bast: bats stab tabs 
abuts: tabus tubas 
bat: tab 
abut: tabu tuba 
technocracies: technocracies 
accidents: desiccant 
cackled: clacked 
caduceus: caucused 
egocentrically: geocentrically 
accessories: accessorise 
canceler: clarence 
accouterments: accoutrements 
accouterment: accoutrement 
certifications: rectifications 
certification: rectification 
alchemic: chemical 
mechanics: mischance 
catechisms: schematics 
catechism: schematic 
catchiest: catechist 
coachmen: comanche 
cachets: catches 
cosmetician: encomiastic 
scarcities: scarcities 
complicates: ectoplasmic 
cocaine: oceanic 
accretions: anorectics 
accretion: anorectic 
icecap: ipecac 
icecaps: ipecacs 
cackler: clacker crackle 
cacklers: crackles 
conservancy: conversancy 
accouters: accoutres coruscate 
accouter: accoutre 
accrues: accuser 
cackling: clacking 
thoracic: trochaic 
conical: laconic 
acrostic: socratic 
cassock: cossack 
cocas: sacco 
decimated: medicated 
undecorated: undercoated 
decadents: descanted 
decadent: decanted 
candide: candied 
aced: dace 
delicateness: delicatessen 
deceases: seedcase 
defacer: refaced 
calendering: greenlandic 
grandnieces: reascending 
chaldee: leached 
chattered: ratcheted 
declaimer: reclaimed 
celandine: decennial 
celandines: decennials 
centralised: credentials 
credential: interlaced 
decimates: medicates 
decimate: medicate 
considerate: desecration 
pederastic: predicates 
underclasses: underclasses 
parceled: replaced 
cleared: declare 
declasse: descales 
amerced: creamed 
endurances: sunderance 
cantered: decanter recanted 
deprecator: procreated 
cratered: retraced terraced 
descartes: scaredest 
catered: created reacted 
decaf: faced 
archfiends: franchised 
identifications: identifications 
deifications: edifications 
deification: edification 
decafs: decafs 
cadge: caged 
decimating: medicating 
decigram: grimaced 
clanged: glanced 
congaed: decagon 
cadger: graced 
charmed: marched 
snatched: stanched 
staunched: unscathed 
crashed: schedar 
cashed: chased 
idealistic: italicised 
larvicide: veridical 
dominatrices: romanticised 
decimations: medications 
decimation: medication 
diametric: matricide 
actinide: indicate 
patricides: pediatrics 
patricide: pediatric 
decimally: medically 
claimed: decimal declaim medical 
decimals: declaims medicals 
candlepin: pinnacled 
consolidates: disconsolate 
citadels: dialects 
citadel: deltaic dialect 
comedian: daemonic demoniac 
dormancies: mordancies 
coordinates: decorations 
coordinate: decoration 
auctioned: cautioned education 
acrider: carried 
cardies: sidecar 
calked: lacked 
arcked: racked 
decal: laced 
collapsed: scalloped 
carolled: collared 
candle: lanced 
calends: candles 
copulated: outplaced 
clasped: scalped 
calder: cradle 
decals: scaled 
compadre: compared 
caromed: comrade 
camped: decamp 
acned: caned dance 
canoed: deacon 
crayoned: deaconry 
craned: dancer 
ascend: dances 
decants: descant scanted 
canted: decant 
costarred: redactors 
educator: outraced 
caped: paced 
carped: redcap 
redcaps: scarped scraped 
arced: cadre cared cedar raced 
carders: scarred 
cadres: cedars sacred scared 
carted: crated redact 
curated: decatur traduce 
carved: craved 
cased: daces 
caused: sauced 
acted: cadet 
discriminator: doctrinairism 
consolidations: disconsolation 
monadic: nomadic 
parodic: picador 
picadors: sporadic 
claud: ducal 
dormancy: mordancy 
candor: conrad dacron 
cads: scad 
mantelpieces: mantlepieces 
mantelpiece: mantlepiece 
faience: fiancee 
faiences: fiancees 
elegiacs: legacies 
categories: categorise 
charterers: recharters 
charterer: recharter 
research: searcher 
cheaters: hectares 
cheater: hectare reteach 
escheat: teaches 
peripatetics: precipitates 
peripatetic: precipitate 
crenelations: intolerances 
crenelation: intolerance 
narcolepsies: precessional 
larcenies: reliances 
centralise: interlaces 
imprecates: spermaceti 
nectarines: transience 
ancienter: nectarine 
conservatoires: conservatories 
conservatoire: overreactions 
ancestries: resistance 
cattinesses: tacitnesses 
careerist: traceries 
creative: reactive 
coeternal: tolerance 
carlene: cleaner 
cleaners: cleanser 
cleansers: clearness 
cerulean: laurence 
cleanse: scalene 
enclaves: valences 
enclave: valence 
escalope: opalesce 
casserole: escaroles 
percale: replace 
percales: replaces 
peculates: speculate 
clearest: treacles 
electra: treacle 
amerce: raceme 
creamers: screamer 
amerces: racemes 
provenances: provenances 
contravene: covenanter 
entrances: renascent 
recanter: recreant terrance 
encase: seance 
escape: peaces 
caterers: retraces terraces 
scatterer: streetcar 
caterer: retrace terrace 
exacter: excreta 
cafe: face 
verifications: versification 
fancies: fiances 
factories: factorise 
cafes: faces 
ethological: theological 
chattering: ratcheting 
cheating: teaching 
cleanings: cleansing 
parceling: replacing 
amercing: creaming germanic 
centigram: cremating 
coarsening: ignorances 
cantering: recanting 
cratering: retracing terracing 
catering: creating reacting 
agency: cagney 
cargoes: corsage 
cager: grace 
ache: each 
hatchery: thearchy 
hatchets: thatches 
challie: helical 
empathic: emphatic 
chennai: enchain 
hurricane: raunchier 
achier: archie 
achiest: aitches 
hackles: shackle 
launcher: relaunch 
cholera: chorale 
choleras: chorales 
charles: larches 
chalets: latches satchel 
chattel: latchet 
charmer: marcher 
charmers: marchers 
marches: schmear 
matcher: rematch 
sachem: schema 
sachems: schemas 
chanters: snatcher stancher tranches 
stauncher: unchaster 
chanter: tranche 
chastens: snatches stanches 
staunchest: unchastest 
arthroscopes: crapshooters 
arthroscope: crapshooter 
chorea: horace 
carthorses: orchestras 
carthorse: orchestra 
choreas: roaches 
cheap: peach 
charters: chartres 
arches: chaser 
chasers: crashes 
archest: chaster 
chatters: ratchets 
aches: chase 
cashes: chases chasse 
chaste: cheats sachet scathe scheat 
cheat: teach 
peristaltic: triplicates 
clarities: realistic 
acrimonies: micronesia 
creationisms: romanticises 
creationism: romanticise 
metrications: monetaristic 
interatomic: metrication 
creationist: recitations 
excitations: intoxicates 
excitation: intoxicate 
antipyretic: pertinacity 
creativity: reactivity 
alice: celia ileac 
calumnies: masculine 
claimer: miracle reclaim 
claimers: miracles reclaims 
clematis: climates 
climaxes: exclaims 
climate: metical 
porcelains: porcelains 
neoplastic: pleonastic 
peculations: speculation 
caroline: cornelia 
actionless: coastlines sectionals 
coastline: sectional 
panicle: pelican 
clarinets: larcenist 
epical: plaice 
caliper: replica 
calipers: replicas spiracle 
particle: prelatic 
slipcase: specials 
claire: eclair lacier 
eclairs: scalier 
articles: recitals 
cavilers: claviers visceral 
article: recital 
lucrative: victualer 
caviler: clavier 
elastics: scaliest 
castile: elastic laciest latices 
lattice: tactile 
anemic: cinema iceman 
campesino: companies 
carmine: crimean mercian 
carmines: cremains 
amnesic: cinemas 
amnestic: semantic 
escapism: scampies 
campiest: campsite 
crimea: mercia 
ceramist: matrices 
conservations: conversations 
conservation: conversation 
ascension: canonises 
incessant: instances 
ancients: canniest instance 
incorporates: procreations 
incorporate: procreation 
procaines: proscenia 
creations: reactions 
creation: reaction 
canoeists: cessation 
aconites: canoeist 
carnie: racine 
arsenic: carnies 
arsenics: raciness 
canisters: scenarist 
canister: scantier 
casein: incase 
issuances: sauciness 
cattiness: scantiest tacitness 
scrapie: spacier 
escapist: spaciest 
aseptic: paciest 
carrie: racier 
carries: scarier 
cartier: erratic 
castries: scariest 
cattier: citrate 
sauciest: suitcase 
lackluster: lacklustre 
calker: clarke 
packer: repack 
packers: repacks 
creaks: sacker 
rackets: restack stacker tackers 
racket: tacker 
alec: lace 
collapse: escallop 
collapses: escallops 
caller: cellar 
callers: cellars recalls scleral 
carlyle: clearly 
calmer: carmel marcel 
camels: mescal 
calumets: muscatel 
clean: lance 
carleton: coltrane 
nuclear: unclear 
cleans: lances 
cantle: lancet 
peculators: speculator 
copulates: outplaces 
copulate: outplace 
carole: oracle 
lactose: locates 
alcoves: coevals 
alcove: coeval 
carpel: parcel placer 
carpels: parcels placers scalper 
capsule: specula upscale 
calque: claque 
clare: clear lacer 
clears: sclera 
cartels: clarets scarlet 
recusal: secular 
cartel: claret rectal 
laces: scale 
castle: cleats eclats 
cleat: eclat 
acme: came mace 
cameron: romance 
cameos: camoes 
campers: scamper 
creams: scream 
acmes: maces 
acne: caen cane 
canoe: ocean 
copartner: procreant 
capstone: opencast 
coarsen: corneas 
coarsens: narcoses 
courtesan: nectarous 
canoes: oceans 
octanes: octanes 
caner: carne crane nacre 
caners: cranes nacres 
canters: nectars recants scanter trances 
centaurs: etruscan recusant 
caverns: cravens 
canter: cretan nectar recant trance 
centaur: uncrate 
cavern: craven 
acnes: canes 
ascents: secants stances 
ascent: enacts secant stance 
capote: toecap 
creators: reactors 
creator: reactor 
coarsest: coasters socrates 
overacts: overcast 
avocet: octave 
cape: pace 
crappers: scrapper 
caper: crape pacer 
carpers: scarper scraper 
scarpers: scrapers 
capers: casper crapes pacers parsec recaps scrape spacer 
parsecs: scrapes spacers 
carpets: precast spectra 
capes: paces space 
cuspate: teacups 
acre: care race 
carer: racer 
carers: racers 
carters: craters tracers 
carter: crater tracer 
acres: cares races scare 
caress: scares 
actress: casters recasts 
causers: saucers 
carets: caster caters crates reacts recast traces 
causer: cesura saucer 
carves: cavers craves 
caret: cater crate react recta trace 
acuter: curate 
carve: caver crave 
aces: case 
causes: sauces 
acutes: cuesta 
cause: sauce 
acute: ceuta 
infarctions: infractions 
infarction: infraction 
califs: fiscal 
frantic: infarct 
falcon: flacon 
fluctuant: untactful 
clanging: glancing 
microphotograph: photomicrograph 
algorithmic: logarithmic 
hackings: shacking 
charming: marching 
snatching: stanching 
nightcap: patching 
arching: chagrin 
chagrins: crashing 
cashing: chasing 
auctioning: cautioning 
cogitations: cogitations 
calking: lacking 
arcking: racking 
sackings: sackings 
collapsing: scalloping 
carolling: collaring 
copulating: outplacing 
clasping: placings scalping 
gymnastic: nystagmic 
magics: magics 
canopying: poignancy 
agincourt: outracing 
agnostic: coasting coatings 
scarping: scraping 
arcing: caring racing 
carings: racings scaring 
carvings: cravings 
carting: crating tracing 
carving: craving 
actings: casting 
causing: saucing 
cigar: craig 
congas: gascon 
crags: scrag 
chlorinations: nonhistorical 
christian: christina 
machismos: masochism 
chromatins: monarchist 
chain: china 
chains: chinas 
chariots: haricots 
chariot: haricot 
chairs: sirach 
aitch: chita 
hacks: shack 
calhoun: lanchou 
chorals: scholar 
monarchs: romansch 
macho: mocha 
machos: mochas 
charm: march 
chasm: machs 
cohan: nacho 
anchor: archon charon rancho 
chants: snatch stanch 
canthus: staunch 
chant: natch 
chapt: patch 
arch: char 
chars: crash 
charts: starch 
chat: tach 
cathy: yacht 
coalitionists: solicitations 
coalitionist: solicitation 
cilia: iliac 
colonialists: oscillations 
colonialist: oscillation 
inactions: onanistic toscanini 
catkin: natick 
cali: laic 
optically: topically 
callosity: stoically 
complaint: compliant 
continual: inoculant 
clarion: conrail 
cilantros: contrails 
cilantro: contrail 
alcuin: lucian uncial 
capitol: optical topical 
curial: uracil uralic 
cavils: slavic 
cattily: tacitly 
manioc: monica 
paronymic: pyromanic 
marconi: minorca 
narcotism: romantics 
maniocs: masonic 
cranium: murcian 
mastics: miscast 
cain: inca 
contains: sanction 
caption: pontiac 
caisson: casinos cassino 
caissons: cassinos 
actions: cations 
auctions: cautions 
action: cation 
auction: caution 
actin: antic 
cairo: coria 
carious: curiosa 
capri: carpi 
aspic: picas 
racists: sacrist 
statics: statics 
attics: static 
catsuit: tacitus 
attic: tacit 
calk: lack 
classworks: crosswalks 
classwork: crosswalk 
calks: lacks slack 
macks: smack 
wracks: wracks 
cask: sack 
casks: sacks 
stack: tacks 
caky: yack 
calm: clam 
calms: clams 
coal: cola 
copulas: cupolas 
copula: cupola 
alcor: carol coral 
carlos: carols corals 
coals: colas 
claps: clasp scalp 
clasps: scalps 
crawls: scrawl 
caryl: lycra 
clays: scaly 
clay: lacy 
cam: mac 
corpsman: crampons 
carom: macro 
caroms: macros marcos 
comsat: mascot 
camps: scamp 
cram: marc 
crams: scram 
marcus: sacrum 
cams: macs scam 
camus: musca sumac 
cannot: canton 
canny: nancy 
corona: racoon 
coronas: racoons 
acorns: carson 
cantors: cartons 
cantor: carton contra craton 
cantos: octans 
cans: scan 
canst: cants scant 
cora: orca 
castors: costars 
actors: castor castro costar scrota 
actor: croat 
ascots: coasts 
ascot: coast coats tacos 
cato: coat taco 
carp: crap 
carps: craps scarp scrap 
scarps: scraps 
catsups: catsups 
arc: car 
arcs: cars scar 
crass: scars 
cary: racy 
casts: scats 
acts: cast cats scat 
act: cat 
catt: tact 
caw: wac 
add: dad 
demanded: maddened 
dawdled: waddled 
deranged: gardened 
degrader: regarded regraded 
adhered: redhead 
deadlier: derailed redialed 
pedaled: pleaded 
demander: remanded 
maundered: undreamed 
departed: predated 
depraved: pervaded 
deadest: sedated 
demandingly: maddeningly 
demanding: maddening 
dangled: gladden 
gadder: graded 
dashed: shaded 
dialed: laddie 
dallied: dialled 
dandier: drained 
jaded: jedda 
addle: laded 
dandle: landed 
duodenal: unloaded 
ladder: larded 
ladders: saddler 
dawdler: drawled waddler 
addles: saddle 
dawdles: swaddle waddles 
dawdle: waddle 
damned: demand madden 
demands: maddens 
dander: darned 
sadden: sanded 
daunted: undated 
adored: deodar 
adder: dared dread 
adders: dreads sadder 
edwards: swarded 
edward: warded 
landholdings: landholdings 
dawdling: waddling 
downloads: woodlands 
download: woodland 
adds: dads 
defeaters: federates 
defeater: federate 
redintegrate: reintegrated 
everglade: leveraged 
released: resealed 
enervated: venerated 
departee: repeated 
seaweeds: seaweeds seesawed 
faltered: reflated 
forwardnesses: frowardnesses 
deafer: feared 
deafest: defeats feasted 
gadgetries: raggediest 
raggedest: staggered 
geraldine: realigned 
endearing: grenadine 
grenadines: serenading 
grenadier: rereading 
deprogrammer: reprogrammed 
angered: derange enraged grandee grenade 
gardener: garnered 
deranges: grandees grenades 
dungaree: underage 
agreed: geared 
ragweed: wagered 
dealership: leadership 
dealerships: leaderships leaderships 
hankered: harkened 
swellhead: wellheads 
haltered: lathered 
adhere: header 
adheres: headers sheared 
earthed: hearted 
jeopardies: jeopardise 
emailed: limeade 
derailments: streamlined 
dateline: entailed 
daliesque: equalised 
realised: sidereal 
denominates: emendations 
denominate: emendation 
impersonated: predominates 
amnestied: dementias 
diameters: dreamiest 
estimated: meditates 
pedantries: pedestrian 
pertained: repainted 
reinstated: straitened 
unreadiest: unsteadier 
dearies: readies 
readiest: steadier 
stateside: steadiest 
deviates: sedative 
lemonades: lemonades 
leaden: leaned 
deplane: paneled 
darlene: leander learned 
unaltered: unrelated 
leaped: pealed 
pearled: pleader 
pleaders: relapsed 
parleyed: replayed 
elapsed: pleased sepaled 
petaled: pleated 
dealer: leader 
dealers: leaders 
desalter: treadles 
alerted: altered related treadle 
delayer: layered relayed 
leased: sealed 
dateless: tasseled 
edema: meade medea 
mannered: menander 
demeanor: enamored 
demeanour: enamoured 
amender: meander renamed 
smartened: tradesmen 
pampered: remapped 
reamed: remade 
mastered: streamed 
edemas: seamed 
deane: deena 
deanne: ennead nadene 
andersen: ardennes ensnared 
earned: endear neared 
adventurers: untraversed 
denatures: sauntered 
attender: nattered 
deanery: yearned 
assented: standees 
danseuse: sudanese 
dapperer: prepared 
pederast: predates 
depraves: pervades 
predate: tapered 
deprave: pervade repaved 
dearer: reader reared reread 
readers: rereads 
arrested: retreads serrated 
retread: treader 
erased: seared 
asserted: dearests 
dearest: sedater 
adverse: evaders 
seated: sedate teased 
deaf: fade 
infuriated: unratified 
afield: failed 
deflations: defoliants 
deflation: defoliant 
defiant: fainted 
foaled: loafed 
alfred: flared 
default: faulted 
deafly: flayed 
farmed: framed 
forwardness: frowardness 
afterwords: forwardest 
fared: freda 
drafters: redrafts 
drafter: redraft 
dafter: farted rafted 
defray: frayed 
aged: egad 
deranging: gardening 
regarding: regrading 
ganged: nagged 
dagger: ragged 
gadget: tagged 
disintegration: disorientating 
misaligned: misdealing misleading 
derailing: redialing 
aligned: dealing leading 
pedaling: pleading 
dealings: leadings signaled 
grandiose: organdies organised 
agonised: diagnose 
departing: predating 
depraving: pervading 
grained: reading 
redrawing: rewarding 
gradient: treading 
angled: dangle glenda 
dangler: gnarled 
dangles: glandes 
gerald: glared 
gamed: madge 
deprogram: programed 
danger: gander garden ranged 
gardner: grander 
dangers: ganders gardens 
dragnets: grandest 
dragnet: granted 
dowagers: wordages 
dowager: wordage 
dagoes: dosage 
dotage: togaed 
gaped: paged 
edgar: grade raged 
gerard: grader regard 
graders: regards 
gyrated: tragedy 
degas: egads 
wadge: waged 
hailed: halide 
admonisher: harmonised 
headpin: pinhead 
deanship: headpins pinheads 
danishes: shandies 
rhapsodies: rhapsodise 
aphrodite: atrophied 
hardier: harried 
dishware: rawhides 
hadjes: jehads 
handel: handle 
handles: handsel 
shetland: stendhal 
hassled: slashed 
halted: lathed 
methadon: thanedom 
mashed: shamed 
handovers: overhands 
handover: overhand 
dorothea: theodora 
phrased: sharped shepard 
phased: shaped 
hared: heard 
dearths: hardest hatreds threads trashed 
dearth: hatred thread 
hydrate: thready 
hades: heads 
deaths: hasted 
death: hated 
hayed: heady 
aide: idea 
dietitian: initiated 
idealism: miladies 
depositional: despoliation 
editorials: idolatries 
dailies: liaised 
admissive: misadvise 
partitioned: trepidation 
dispraiser: disrepairs 
dairies: diaries 
aristides: satirised 
kidnapers: spikenard 
ailed: delia ideal 
pallider: pillared 
dallier: rallied 
dallies: sallied 
maidenly: medianly 
misdeal: mislead 
misdeals: misleads 
medalist: misdealt 
alined: daniel delian denali denial nailed 
idolaters: steroidal 
idolater: tailored 
diastole: isolated 
dovetail: violated 
platitudes: stipulated 
derail: dialer railed redial relaid 
derails: redials 
trailed: trialed 
ideals: ladies sailed 
details: dilates 
altitudes: latitudes 
detail: dilate tailed 
altitude: latitude 
aimed: amide media 
maiden: median medina 
dominates: maidstone 
maidens: medians sideman 
amortised: mediators 
admire: merida 
admirer: married 
admirers: marrieds 
admires: misread sidearm 
misreads: sidearms 
amides: medias 
mideast: misdate 
andine: dianne nadine 
denotations: detonations 
denotation: detonation 
inundates: unstained 
ordinate: rationed 
antidotes: stationed 
unpaired: unrepaid 
dairen: denari derain rained 
drainer: randier 
sandier: sardine 
aridness: sardines 
randiest: strained 
eridanus: unraised 
indurate: urinated 
detains: instead sainted stained 
dwaine: edwina 
isadore: roadies 
diaper: paired repaid 
parried: rapider 
aspired: despair diapers praised 
rapidest: traipsed 
partied: pirated 
aider: aired 
tardier: tarried 
astride: staider tirades 
striated: tardiest 
aides: aside ideas sadie 
asides: daises 
distaste: staidest 
sideways: waysides 
advise: visaed 
adjusters: readjusts 
adjuster: readjust 
knead: naked 
danker: darken narked ranked 
kneads: snaked 
kayoed: okayed 
drake: raked 
skated: staked tasked 
dale: deal lade 
lead: leda 
patrolled: portalled 
allotted: totalled 
ardell: ladler 
lamed: medal 
delmar: dermal 
damsel: medals 
alden: eland laden 
delano: loaned 
slander: snarled 
launder: lurdane 
leopard: paroled 
laredo: loader ordeal reload 
loaders: ordeals reloads 
leotards: lodestar 
dapples: slapped 
lapsed: pedals pleads 
adler: alder 
darrel: larder 
dales: deals lades leads 
deltas: desalt lasted salted slated staled 
salved: slaved 
delays: slayed 
dealt: delta 
waled: weald 
daley: delay 
dame: edam made mead 
admen: amend maned medan named 
mundane: unnamed 
daemon: moaned modena 
namedrop: pomander 
namedrops: pomanders 
underarm: unmarred 
manured: maunder unarmed 
samoyed: someday 
dampest: stamped 
armed: derma dream 
dames: meads 
amused: medusa 
mated: tamed 
aden: dane dean dena edna 
annoyed: anodyne 
aproned: operand padrone 
atoned: donate 
append: napped 
appends: snapped 
prawned: predawn 
expands: spandex 
panted: pedant 
andre: arden denar nader 
darner: errand 
darners: errands 
sander: snared 
asunder: danseur 
wanders: wardens 
ardent: ranted 
natured: unrated 
neruda: unread 
andrew: wander warden warned 
andes: deans sedan 
unstated: untasted 
anted: dante 
attuned: taunted 
auden: duane 
awned: waned 
dwayne: yawned 
predators: teardrops 
parroted: predator prorated teardrop 
portrayed: predatory 
adopters: readopts 
adopter: readopt 
adore: oared oread 
adorer: roared 
adores: soared 
dapper: rapped 
drape: padre pared raped 
draper: parred 
drapers: sparred 
drapes: padres parsed rasped spader spared spread 
departs: petards 
depart: parted petard prated 
passed: spades 
adepts: pasted 
adept: taped 
dare: dear 
darer: drear 
darters: retards starred traders 
drawers: redraws rewards warders 
darter: retard tarred trader 
drawer: redraw reward warder warred 
arsed: dares dears reads 
daters: stared trades treads 
adverts: starved 
seward: waders 
dater: rated tared trade 
deary: ready 
dates: sated stead 
stated: tasted 
stayed: steady 
dawes: sawed wades 
adzes: dazes 
dave: veda 
awed: wade 
adze: daze 
handoff: offhand 
handfuls: handsful 
forwardly: frowardly 
forward: froward 
dag: gad 
grading: niggard 
dashing: shading 
darling: larding 
languid: lauding 
darting: trading 
drawing: warding 
danzig: dazing 
aground: durango 
dago: goad 
dagos: goads 
drag: grad 
drags: grads 
durga: guard 
dags: gads 
hasidism: hassidim 
hadji: jihad 
hadjis: jihads 
haploids: shipload 
ladyships: ladyships 
honduras: rhodanus 
handouts: thousand 
handy: haydn 
hardtops: potshard 
hoard: rhoda 
hardy: hydra 
dash: shad 
aid: ida 
misdial: mislaid 
admonitions: dominations 
admonition: domination 
kidnaps: skidpan 
dali: dial laid 
lorinda: ordinal 
ordinals: rosalind 
adroitly: dilatory idolatry 
valid: vidal 
daily: lydia 
amid: maid 
monadism: nomadism 
daimon: domain 
domains: madison 
diatoms: mastoid 
maids: midas 
admits: amidst 
dian: dina 
inroad: ordain 
inroads: ordains sadiron 
dinar: drain nadir 
dinars: drains nadirs 
darwin: inward 
divans: viands 
divan: viand 
isador: radios 
arid: raid 
astrid: triads 
darius: radius 
dairy: diary 
aids: dais dias said 
davis: divas 
avid: diva vida 
roadworks: roadworks 
vodkas: vodkas 
moorlands: moorlands 
donal: ndola nodal 
arnold: roland ronald 
dylan: lynda 
swordplay: wordplays 
daryl: lardy 
auld: dual laud luda 
dam: mad 
monad: nomad 
doorman: madrono 
dormant: mordant 
damson: nomads 
dynamo: monday 
stardom: tsardom 
dams: mads 
and: dan 
donator: tornado 
adorn: radon ronda 
adorns: andros radons sondra 
outdrawn: untoward 
dustpans: standups 
dustpan: standup 
darn: nard rand 
durant: tundra 
sudan: sunda 
dawns: wands 
dawn: wand 
dora: odra 
outdraws: outwards 
outdraw: outward 
ados: soda 
toady: today 
quads: squad 
ards: rads 
draws: sward wards 
drays: yards 
dart: drat trad 
draw: ward 
dray: yard 
ads: sad 
attentivenesses: tentativenesses 
statelessnesses: tastelessnesses 
theatergoers: theatregoers 
theatergoer: theatregoer 
generates: teenagers 
generate: teenager 
eagerest: steerage 
earthinesses: heartinesses 
haplessnesses: shapelessness 
attentiveness: tentativeness 
lamenesses: malenesses 
statelessness: tastelessness 
enervates: venerates 
enervate: venerate 
repartees: repeaters 
repartee: repeater 
persiflage: pilferages 
fealties: leafiest 
faeries: freesia 
forenames: freemason 
fasteners: refastens 
fastener: refasten 
rehearings: rehearsing 
restraighten: straightener 
gatherers: regathers 
gatherer: regather 
gainesville: villeinages 
legalities: legalities 
regularities: regularities 
interrogatives: tergiversation 
integrative: vinaigrette 
allergies: galleries 
enameling: meningeal 
eglantine: inelegant 
releasing: resealing 
ensilage: lineages 
agileness: ensilages 
gelatine: legatine 
impregnate: permeating 
argentine: tangerine 
enervating: venerating 
orangeries: reorganise 
argentite: integrate 
enlarge: general gleaner 
enlarges: generals gleaners 
galere: regale 
eaglets: legates 
eaglet: legate 
manege: menage 
maneges: menages 
meager: meagre 
gamester: meagrest 
enrage: genera 
estranges: greatness sergeants 
estrange: grantees reagents sergeant 
avengers: engraves 
grantee: reagent 
avenger: engrave 
avenge: geneva 
agree: eager 
agrees: grease 
earthliest: stealthier 
empathies: empathise 
earthiness: heartiness 
apheresis: pharisees 
earthier: heartier 
earthiest: heartiest 
leathers: leathers 
resharpen: sharpener 
resharpens: sharpeners 
earthen: hearten teheran 
athene: ethane 
seahorse: seashore 
seahorses: seashores 
housewares: warehouses 
euphrates: superheat 
hearer: rehear 
hearers: rehears shearer 
heaters: reheats theresa 
theaters: theatres 
weathers: wreathes 
heater: reheat 
theater: theatre thereat 
weather: whereat wreathe 
heaves: sheave 
israelite: realities 
imperatives: semiprivate 
asperities: patisserie 
jeanine: jeannie 
alikeness: leakiness 
alinements: lineaments 
entailments: sentimental 
alinement: lineament 
marilee: mealier 
maliseet: mealiest 
aileen: elaine 
levantine: valentine 
explainer: reexplain 
palestine: penalties tapelines 
saltinesses: stainlesses 
lazinesses: sleaziness 
attentively: tentatively 
ateliers: earliest realties 
literates: statelier 
relatives: versatile 
realizes: sleazier 
asymmetries: asymmetries 
enumerations: mountaineers 
enumeration: mountaineer 
impersonate: permeations 
amnesties: meatiness 
masteries: smeariest 
emirates: steamier 
emerita: emirate meatier 
estimates: steamiest 
estimate: meatiest teatimes 
penetrations: presentation 
enervations: venerations 
enervation: veneration 
entertains: tenantries 
retainers: ternaries 
eritrean: retainer 
irateness: teariness 
retinae: trainee 
attentive: tentative 
evaporite: operative 
appetiser: paperiest 
striptease: tapestries 
eritrea: tearier 
aeries: easier 
iterates: teariest treaties treatise 
sweatier: weariest 
jayvee: veejay 
rewaken: wakener 
overtakes: takeovers 
overtake: takeover 
walleyes: weaselly 
lameness: maleness nameless salesmen 
example: exempla 
meatless: tameless 
arleen: arlene leaner 
learner: relearn 
learners: relearns 
enteral: eternal 
enslave: leavens 
leaper: repeal 
leapers: relapse repeals 
saltpeters: saltpetres 
saltpeter: saltpetre 
asleep: elapse please 
elapses: pleases 
leaser: reales resale reseal sealer 
earless: leasers resales reseals sealers 
realest: relates stealer 
leavers: reveals several 
leaver: reveal 
easel: lease 
easels: leases 
stateless: tasteless 
elates: stelae teasel 
teazels: teazles 
teazel: teazle 
enema: nemea 
meaner: rename 
enemas: seamen 
massenet: tameness 
statements: testaments 
statement: testament 
tampere: tempera 
remasters: streamers 
remaster: streamer 
measures: reassume 
penetrant: repentant 
ensnares: nearness 
annette: nanette 
esperanto: personate 
enervator: venerator 
earner: nearer 
assenter: earnests 
earnest: eastern nearest 
astuteness: tautnesses 
sateens: senates sensate 
santee: sateen senate 
operettas: poetaster 
overate: overeat 
paperer: prepare 
paperers: prepares 
reapers: spearer 
pareses: serapes 
pareve: repave 
arrester: rearrest 
asserter: reassert 
erasures: reassure 
austerer: treasure 
swearer: wearers 
retreat: treater 
erase: saree 
erases: sarees 
teasers: tessera 
easter: eaters teaser teresa 
restate: retaste 
arete: eater 
affirmer: reaffirm 
restaffs: staffers 
restaff: staffer 
finagle: leafing 
faltering: reflating 
faithless: flashiest 
fashioner: refashion 
fashioners: refashions 
infestation: sinfonietta 
florentia: reflation 
fannie: fenian 
faker: freak 
fakers: freaks 
fakery: freaky 
flea: leaf 
formulae: fumarole 
teaspoonfuls: teaspoonsful 
florae: loafer 
floater: refloat 
feral: flare 
falser: flares 
earfuls: refusal 
refutal: tearful 
false: fleas leafs 
falsest: fatless 
flatuses: sulfates 
farmer: framer 
farmers: framers 
fastens: fatness 
fasten: stefan 
fare: fear 
rafters: strafer 
fares: fears safer 
afters: faster strafe 
faery: fayer freya 
feasts: safest 
fates: feast feats fetas 
fayest: safety 
fate: feat feta 
ganglier: regaling 
angering: enraging 
georgian: georgina 
gearings: greasing 
gargle: lagger 
grange: nagger 
granges: naggers 
stagger: taggers 
aggeus: gauges 
photographers: rephotographs 
photographer: rephotograph 
hankering: harkening 
anthologies: theologians 
earthlings: slathering 
earthling: haltering lathering 
shattering: straighten 
earthing: ingather 
nightwear: wreathing 
laughters: slaughter 
heptagons: pathogens 
heptagon: pathogen 
hangovers: overhangs 
hangover: overhang 
hanger: rehang 
hangers: rehangs 
petrography: typographer 
genitival: vigilante 
impersonating: impregnations 
integration: orientating 
pertaining: repainting 
reinstating: straitening 
leaking: linkage 
legalism: millages 
granville: ravelling 
allegorists: legislators 
allegorist: legislator 
pillages: spillage 
legalist: tillages 
alignment: lamenting 
germinal: maligner malinger 
ealing: genial linage 
regulation: urogenital 
leaping: pealing 
parleying: replaying 
elapsing: pleasing 
aligner: realign 
aligners: realigns salinger signaler slangier 
integrals: triangles 
starveling: travelings 
layerings: searingly yearlings 
alerting: altering integral relating triangle 
layering: relaying yearling 
leasing: linages sealing 
slangiest: tasseling 
gelatins: genitals stealing 
leavings: svengali 
elating: gelatin genital 
apologies: apologise 
gisela: silage 
agilest: ligates 
enigma: gamine 
pampering: remapping 
mangier: reaming 
emigrants: mastering streaming 
geraniums: measuring 
enigmas: gamines seaming 
mangiest: mintages steaming 
mintage: teaming 
gamier: margie mirage 
migrates: ragtimes 
migrate: ragtime 
ageism: images 
antigone: negation 
earning: grannie nearing 
earnings: grannies 
angriness: ranginess 
assenting: tanginess 
antigens: gentians 
guanines: sanguine 
anteing: antigen gentian 
anguine: guanine guinean 
agonies: agonise 
angrier: earring 
regain: regina 
rangier: rearing 
registrant: restarting 
erasing: gainers regains 
assigners: reassigns 
angriest: gantries granites ingrates rangiest tangiers 
granite: ingrate tangier tearing 
twangier: watering 
assessing: gassiness 
giantess: seatings 
seating: teasing 
gaiters: stagier triages 
aigret: gaiter triage 
gael: gale 
allergy: gallery largely regally 
galluses: seagulls 
legman: mangle 
gamely: gleamy 
angel: angle galen glean 
wanglers: wrangles 
wangler: wrangle 
angels: angles gleans 
galore: gaoler 
alger: elgar glare lager large regal 
glares: lagers larges 
game: mega 
gammer: gramme 
mange: megan 
magnetos: megatons montages 
magneto: megaton montage 
engram: german manger 
engrams: mangers 
gasmen: manges 
augments: mutagens 
augment: mutagen 
programer: reprogram 
programers: reprograms 
gamer: marge 
argonne: garonne 
anger: range 
garner: ranger 
garners: rangers 
granters: stranger 
angers: ranges sanger 
argents: garnets sargent strange 
argent: garnet 
gnawer: wagner 
gestapos: postages 
gestapo: postage 
gatepost: pottages 
garotes: storage 
garote: tagore 
gape: page 
grape: pager 
grapes: pagers sparge 
gapes: gaspe pages 
gear: rage 
garrets: garters graters 
garret: garter grater 
gears: rages sager sarge 
grates: greats 
grayest: gyrates 
argues: augers 
gazers: grazes 
gater: grate great greta 
argue: auger 
gazer: graze 
ages: sage 
gases: sages 
sagest: stages 
gates: stage 
gayest: stagey 
agues: usage 
gave: vega 
heavyish: yeshivah 
harshest: thrashes 
heaths: sheath 
histamine: thiamines 
hernial: inhaler 
earthily: heartily 
elisha: sheila shelia 
harmonies: harmonise 
emphasis: misshape 
shipmates: steamship 
sympathies: sympathise 
hernias: nearish 
epitaphs: happiest 
harpies: sharpie 
parishes: sharpies 
swarthiest: sweatshirt 
atheists: hastiest 
hanker: harken 
hankers: harkens 
hakes: shake 
hale: heal leah 
harlem: mahler 
hamlet: thelma 
hapless: plashes 
halters: lathers slather 
halter: lather 
earthly: lathery 
hales: heals leash sahel shale 
hassle: lashes shales 
hassles: slashes 
halest: lathes thales 
whales: wheals 
ashley: halsey shaley 
halve: havel 
whale: wheal 
hammers: shammer 
horseman: menorahs 
arnhem: herman 
harems: masher shmear 
marshes: mashers smasher 
amherst: hamster 
mashes: shames 
haunters: unearths 
anther: tehran 
haunter: unearth 
ashen: shane 
athens: hasten thanes 
havens: shaven 
ethan: neath thane 
pathoses: potashes 
ashore: hoarse 
earshots: hoarsest 
phrase: seraph shaper sherpa 
phrases: seraphs 
heaps: phase shape 
phases: shapes 
hare: hear hera rhea 
rasher: sharer 
rashers: sharers 
hares: hears rheas share shear 
rashes: shares shears 
rashest: trashes 
hawsers: washers 
earths: haters hearst hearts 
hatters: shatter threats 
hawser: rewash washer 
earth: harte hater heart herat rathe 
hatter: threat 
earthy: hearty 
haste: hates heats 
swathe: wheats 
haves: shave 
hayes: yeahs 
hate: heat 
militaries: militarise 
sterilizations: sterilizations 
eliminators: normalities orientalism 
alienist: litanies 
solitaires: solitaries 
liaises: silesia 
airtimes: seriatim 
annuities: insinuate 
estivation: novitiates 
inertias: rainiest 
sanities: sanitise 
parities: parities 
satirise: tiresias 
ratlike: talkier 
aiken: kenai 
ileal: leila lelia 
millstream: smalltimer 
literals: talliers 
literal: tallier 
allies: sallie 
melian: menial 
lineman: melanin 
linesman: melanins 
laminose: semolina 
melanosis: semolinas 
manlier: mineral 
terminals: tramlines 
menials: seminal 
ailments: aliments manliest 
ailment: aliment 
loamier: morelia 
impaler: lempira palmier 
mailers: realism 
emails: mesial 
aimless: melissa 
mutilates: stimulate ultimates 
mutilate: ultimate 
alien: aline 
antinovel: valentino 
potentials: potentials 
aileron: loraine 
orientals: relations 
oriental: relation tirolean 
elations: toenails 
elation: toenail 
alpine: nepali pineal 
plainer: praline 
interplay: painterly 
panelist: plainest 
arline: linear nailer 
entrails: latrines ratlines 
latrine: ratline reliant retinal 
aliens: alines saline 
saltiness: stainless 
salients: saltines 
entails: salient saltine 
paltrier: pretrial 
quartile: requital 
retrials: trailers 
retrial: trailer 
realist: retails saltier 
irately: reality tearily 
aisle: elias 
aisles: lassie 
summaries: summarise 
amine: anime maine 
mensuration: numerations 
minnesota: nominates 
importunate: permutation 
moraine: romaine 
moraines: romaines romaines 
airmen: mainer marine remain 
marines: remains seminar 
minarets: raiments 
antiserum: ruminates 
aneurism: sumerian suriname 
minaret: raiment 
amiens: inseam 
inseams: messina 
inmates: samnite 
amenity: anytime 
maxine: xiamen 
amortizes: atomizers 
amortize: atomizer 
marie: ramie 
armies: ramies 
artemis: maestri 
annie: inane 
innovates: venations 
innovate: venation 
instanter: intranets transient 
tyrannies: tyrannise 
insane: sienna 
atropines: patronise 
assertion: senoritas 
notaries: senorita 
napier: panier rapine 
terrapins: transpire 
paniers: persian rapines 
painters: pantries pertains repaints 
painter: pertain repaint 
panties: sapient 
pantie: petain 
antiquer: quainter 
restrains: strainers 
restrain: retrains strainer terrains trainers 
retrain: terrain trainer 
arisen: sarnie 
artiness: retsinas 
rattiness: resistant straitens 
antsier: nastier retains retinas retsina 
nitrates: straiten 
retain: retina tirane 
nattier: nitrate 
taurine: urinate 
tawnier: tinware 
naiver: ravine vainer 
aisne: anise 
sestina: tansies 
antsiest: instates nastiest 
naivest: natives vainest 
naevi: naive 
pretoria: priorate 
apprise: sappier 
rapier: repair 
aspirer: parries rapiers raspier repairs 
aspire: persia praise 
aspires: paresis 
praises: spireas 
pastries: piasters piastres raspiest traipses 
parties: pastier piaster piastre pirates traipse 
piraeus: upraise 
pasties: patsies 
raiser: sierra 
raisers: sierras 
artsier: tarries 
arrive: rivera 
aries: arise raise 
arises: raises 
artistes: artsiest 
satire: striae 
artiest: artiste attires striate tastier 
rattiest: tartiest 
waiters: wariest 
tattier: titrate 
waiver: wavier 
jane: jean jena 
kale: lake leak 
lanker: rankle 
anklets: lankest 
stalker: talkers 
kales: lakes leaks slake 
kame: make 
kerman: menkar 
teamworks: workmates 
teamwork: workmate 
maker: merak 
marker: remark 
markers: remarks 
makers: masker 
rankest: tankers 
swanker: wankers 
newark: wanker 
snake: sneak 
snakes: sneaks 
outtakes: stakeout takeouts 
outtake: takeout 
peaks: spake speak 
quakes: squeak 
asker: rakes 
skaters: streaks 
skater: streak takers 
skates: stakes steaks 
keats: skate stake steak takes teaks 
askew: wakes 
kate: take teak 
wake: weak 
ale: lea 
ella: lela 
allover: overall 
allures: laurels 
allure: laurel 
elam: lame male meal 
neoplasm: pleonasm 
neoplasms: pleonasms 
mensural: numerals 
laments: mantels mantles 
lament: mantel mantle mental 
laymen: manley meanly namely 
salerooms: salesroom 
ample: maple 
ampler: palmer 
maples: sample 
lamer: realm 
armlet: martel 
lames: males meals salem selma 
lamest: metals 
melva: velma 
elan: lane lean lena neal 
alone: anole leona 
lenora: loaner 
loaners: orleans salerno 
ornately: tyrolean 
nepal: panel penal plane plena 
planters: replants 
purslane: supernal 
planter: replant 
naples: panels planes 
planets: platens 
planet: platen 
aplenty: penalty 
arlen: larne learn renal 
antlers: rentals 
antler: learnt rental 
neutral: renault 
lauren: neural unreal 
lavern: vernal 
elans: lanes leans 
sensual: unseals 
latent: talent 
navel: venal 
espousal: sepalous 
realtor: relator 
layovers: overlays 
layover: overlay 
leap: pale 
peal: plea 
rappels: slapper 
applets: lappets 
applet: lappet 
paler: pearl 
lapser: pearls 
plasters: staplers 
parsleys: sparsely 
plaster: psalter stapler 
platters: prattles splatter 
parleys: parsley players replays sparely 
platter: prattle 
parley: pearly player replay 
lapse: leaps pales peals pleas sepal 
lapses: passel sepals 
passels: sapless 
pastels: staples 
palest: pastel petals plates pleats staple 
leapt: lepta petal plate pleat 
equals: squeal 
equal: quale 
earl: lear rale real 
earls: lares laser rales 
starlets: startles 
salvers: slavers 
alerts: alters salter staler 
latters: rattles starlet startle 
travels: varlets 
ravels: salver slaver velars 
layers: relays slayer 
alert: alter later taler 
latter: rattle 
tartlet: tattler 
travel: varlet 
ravel: velar 
lawyer: warley 
laxer: relax 
early: layer leary relay 
ales: elsa leas sale seal 
sales: seals 
leasts: slates stales steals tassel 
latests: saltest stalest 
salutes: taluses 
salves: slaves 
least: slate stael stale steal stela tales teals tesla 
latest: lattes 
valets: vestal 
exalts: laxest 
laves: salve slave vales valse veals 
swale: wales weals 
lazes: zeals 
late: tale teal 
exalt: latex 
elva: lave leva vale veal vela 
wale: weal 
alex: axle 
laze: zeal 
manometry: momentary 
amen: mane mean name 
enamor: moaner morean 
enamors: moaners oarsmen 
monastery: oysterman 
marne: namer ramen 
martens: smarten 
manures: surname 
manes: manse means mensa names 
mantes: stamen 
ament: manet meant 
remora: roamer 
mapper: pamper 
mappers: pampers 
stamper: tampers 
tempuras: upstream 
revamp: vamper 
marques: masquer 
erma: mare ream 
armrest: smarter 
rewarms: warmers 
erratum: maturer 
rewarm: warmer 
mares: maser reams 
ramses: smears 
masters: streams 
mattress: smartest 
erasmus: masseur 
master: maters stream tamers 
matters: smatter 
mater: tamer 
mesa: same seam 
mesas: seams 
amuses: assume 
mates: meats steam tames teams 
mattes: tamest 
mateys: mayest steamy 
exams: maxes 
samey: seamy 
mate: meat tame team 
matey: meaty 
tannest: tenants 
postseason: soapstones 
soapstone: teaspoons 
pearson: persona 
patroness: transpose 
operant: pronate protean 
reason: senora 
reasons: senoras 
assentor: senators treasons 
senator: treason 
atoner: ornate 
aeons: saone 
atone: oaten 
nape: neap pane 
napper: rappen 
nappers: snapper 
pasterns: raptness 
entraps: napster parents pastern 
patterns: transept 
entrap: parent 
aspen: napes neaps panes 
aptness: patness 
arne: earn near 
errant: ranter 
warner: warren 
earns: nares nears saner snare 
nasser: snares 
answers: rawness 
astern: sterna 
natures: saunter 
servant: taverns 
vaunter: ventura 
raven: verna 
yaren: yearn 
sane: sean 
assent: sanest 
antes: nates 
attunes: tautens tetanus 
austen: unseat 
evans: naves vanes 
wanes: weans 
ante: etna neat 
attune: tauten 
taney: yenta 
evan: nave neva vane 
anew: wane wean 
praetors: prorates 
praetor: prorate 
overpass: passover 
equator: quorate 
assertor: assorter roasters 
rosetta: rotates 
arouse: roseau 
ape: pea 
papers: sapper 
papery: prepay yapper 
earp: pare pear rape reap 
parer: raper 
parers: parser rapers sparer 
resprays: sprayers 
prayers: respray sprayer 
prewar: rewrap warper 
pares: parse pears rapes reaps spare 
parses: passer 
repass: spares sparse 
sparsest: trespass 
repasts: sparest 
paters: prates repast tapers 
patters: spatter tapster 
pasteur: pasture 
payers: repays 
apter: pater petra prate taper 
payer: peary repay 
apes: apse peas 
apses: passe 
pastes: spates stapes 
paste: pates peats septa spate tapes 
pate: peat tape 
quartets: squatter 
are: ear era rae 
rare: rear 
rares: rears serra 
arrests: starers 
restarts: starters 
arrest: rarest raster raters sartre starer 
ratters: restart starter 
ratter: tarter 
ares: arse ears eras 
sear: sera 
assert: asters stares 
swears: wrasse 
aster: rates resat stare tares tears 
taster: taters tetras treats 
tartest: tatters 
astuter: stature 
stewart: swatter 
averts: starve vaster 
rawest: waster waters 
extras: taxers 
avers: raves saver 
sawer: swear wares wears 
sayer: years 
rate: tare tear 
tater: tetra treat 
extra: taxer 
aver: rave vera 
ware: wear 
aery: ayer yare year 
ezra: raze 
assess: sasses 
asset: easts sates seats 
states: tastes 
astutest: statutes 
sweats: wastes 
saves: vases 
east: eats etas sate seat teas 
state: taste 
statute: tautest 
astute: statue 
stave: vesta 
sweat: waste 
taxes: texas 
yeast: yeats 
save: vase 
ayes: easy yeas 
ate: eat eta tea 
etta: teat 
aye: yea 
funfairs: ruffians 
funfair: ruffian 
foaling: loafing 
farming: framing 
raftings: strafing 
farting: rafting 
hafts: shaft 
filtrations: flirtations 
filtration: flirtation 
fakir: kafir 
pailfuls: pailsful 
formalin: informal 
flatiron: inflator 
flair: frail 
fain: naif 
friary: rarify 
fiat: taif 
fallouts: outfalls 
fallout: outfall 
armfuls: armsful 
foal: loaf 
foals: loafs 
aloft: float 
faults: flatus 
fauns: snafu 
afro: faro fora 
oafs: sofa 
ofay: yafo 
farts: frats rafts 
fart: frat raft 
frau: urfa 
fast: fats 
aft: fat 
laggings: slagging 
ganging: nagging 
gnashing: hangings 
ganglions: singalong 
grayling: ragingly 
aging: nigga 
gaping: paging 
agings: niggas 
gazing: niggaz 
loathingly: tallyhoing 
algorithms: logarithms 
algorithm: logarithm 
spanglish: splashing 
hassling: lashings slashing 
halting: lathing 
mashing: shaming 
phrasing: sharping 
phasing: shaping 
garnish: sharing 
hastings: stashing 
swashing: washings 
gnash: hangs 
gash: hags shag 
alining: nailing 
intaglios: isolating ligations 
intaglio: ligation 
trailing: trialing 
rivaling: virginal 
intagli: tailing 
amortising: migrations 
ingrain: raining 
straining: trainings 
aspiring: pairings praising 
airings: arising raising 
makings: masking 
narking: ranking 
kayoing: okaying 
parkings: sparking 
skating: staking takings tasking 
gail: gila 
galliums: gaullism 
allotting: totalling 
sallying: signally 
gilman: laming malign 
lapsing: palings sapling 
platings: stapling 
palsying: splaying 
aligns: signal 
lasting: salting slating staling 
salving: slaving 
organism: roamings 
arming: margin 
migrants: smarting 
mating: taming 
amigo: imago 
agism: sigma 
gain: gina 
spawning: wingspan 
attuning: taunting 
awning: waning 
parroting: prorating 
garrison: roarings 
signora: soaring 
assorting: organists roastings 
organist: roasting 
gyrations: signatory 
toasting: tsingtao 
strapping: trappings 
paring: raping 
parings: parsing rasping sparing 
parting: prating 
arsing: grains 
gratins: ratings staring 
stingray: straying 
gratin: rating taring 
ratting: tarting 
assigns: sassing 
giants: sating 
stating: tasting 
staying: stygian 
agist: gaits 
gal: lag 
along: anglo logan 
glans: slang 
gaol: goal olga 
gaols: goals lagos 
gals: lags 
slags: slags 
groomsman: monograms 
among: mango 
organon: rangoon 
argon: groan orang organ 
argons: groans organs sargon sarong 
tango: tonga 
prangs: sprang 
gran: rang 
angry: rangy 
nags: sang snag 
angst: gnats tangs 
gnat: tang 
ago: goa 
argots: gators groats 
argot: gator groat 
goats: togas 
goya: yoga 
gaps: gasp 
gar: rag 
gars: rags 
argus: sugar 
gary: gray 
gas: sag 
stag: tags 
swag: wags 
ah: ha 
hash: shah 
isthmian: thiamins 
palish: phials 
aphorism: morphias 
poisha: sophia 
aphis: apish 
harris: sirrah 
hairs: shari 
ankh: hank khan 
ankhs: hanks khans shank 
harks: shark 
hallows: shallow 
halls: shall 
harlow: warhol 
halos: shoal 
altho: loath 
haply: phyla 
hals: lash 
halts: laths shalt 
hauls: hulas 
halt: lath 
haul: hula 
huntsman: manhunts 
hampton: phantom 
hamsun: humans 
human: nahum 
mashups: smashup 
harms: marsh 
hams: mash sham 
shams: smash 
maths: maths 
han: nah 
hans: nash 
haunts: sunhat 
haunt: utahn 
pashto: pathos potash 
hoar: hora 
authors: suharto 
hosta: oaths shoat 
hap: pah 
harps: sharp 
haps: hasp 
paths: staph 
path: phat 
harts: rasht trash 
arhus: surah 
hart: thar 
ash: has 
hast: hats shat 
swath: thaws whats 
haws: shaw wash 
ashy: hays shay 
thaw: what 
visitation: vitiations 
mutilations: stimulation 
positional: spoliation 
nativism: vitamins 
nitrations: transition 
insinuator: ruinations urinations 
ruination: urination 
attrition: titration 
nativist: visitant 
satirists: sitarists 
satirist: sitarist 
jinan: ninja 
kumasi: umiaks 
akin: kina 
ail: ali 
illampu: pallium 
littorals: tortillas 
littoral: tortilla 
liam: lima mail mali 
olympian: palimony 
alumni: lumina 
mutilators: stimulator 
palmists: psalmist 
altruisms: muralists 
altruism: muralist 
islam: mails 
latium: ultima 
lain: nail 
tonsorial: torsional 
lapin: plain 
lapins: plains spinal 
plaint: pliant 
insular: urinals 
nails: slain snail 
instal: stalin 
nastily: saintly 
anvils: silvan 
alvin: anvil vilna 
royalist: solitary 
tolyatti: totality 
viola: voila 
pastil: plaits 
aril: lair lari liar lira rail rial 
lairs: liars liras rails rials 
trails: trials 
trail: trial 
rival: viral 
ails: lisa sail 
sails: silas sisal 
litas: tails 
alit: lati tail tali 
italy: laity 
vail: vial vila 
aim: mia 
imam: maim 
maoism: mimosa 
imams: maims 
amin: main 
amnion: minoan 
amnions: mansion onanism 
antimony: antinomy 
amnio: naomi omani 
marion: romani 
antrim: martin 
mantis: matins 
maori: mario 
maoist: taoism 
pamir: priam 
armpits: imparts 
armpit: impart 
amir: irma mira 
ani: ian ina 
anoints: nations onanist 
anoint: nation 
ontario: oration 
puritans: rasputin 
pains: pisan spain 
inapt: paint 
iran: rain rani 
naris: rains ranis 
strain: trains 
transit: tristan 
saints: satins stains 
antis: saint satin stain 
taints: titans 
sanity: satiny 
swain: wains 
anti: nita tina 
taint: titan 
ivan: vain 
patios: patois 
aorist: ratios rosita satori 
saviour: various 
ratio: troia 
iotas: ostia 
pairs: paris 
rapist: tapirs 
pitas: pitas 
patti: pitta 
pizazz: pizzaz 
air: ira 
airs: sari 
sitars: stairs 
artists: straits tsarist 
astir: sitar stair stria tarsi 
artist: strait strati traits 
airy: iyar 
assist: stasis 
vista: vitas 
waist: waits 
siva: visa 
jason: jonas sonja 
jaunts: juntas 
jaunt: junta 
jar: raj 
kolas: skoal 
outwalk: walkout 
karl: lark 
stalk: talks 
amok: mako 
akron: koran krona 
nark: rank 
narks: ranks 
stank: tanks 
swank: wanks 
snaky: yanks 
kant: tank 
oak: oka 
oaks: soak 
kayos: okays 
kayo: okay 
parks: spark 
karst: karts stark 
auks: sauk skua 
kay: yak 
al: la 
mallory: morally 
malls: small 
lola: olla 
allots: atolls 
allows: sallow 
swallow: wallows 
allot: atoll 
tallowy: tollway 
alloy: loyal 
molnar: normal 
lyman: manly 
lamppost: palmtops 
molar: moral 
molars: morals 
lamp: palm 
lamps: palms plasm psalm 
amply: palmy 
marly: mylar 
alms: lams slam 
alyssum: asylums 
alums: mauls 
mutual: umlaut 
alum: maul 
lonna: nolan 
lorna: ronal 
loans: salon 
alton: talon tonal 
lunar: ulnar 
sultan: tulsan 
ulnas: ulsan 
patrols: portals 
postural: pulsator 
patrol: portal 
opals: salop 
arlo: lora oral 
orals: solar 
ovular: valour 
orval: valor 
also: laos 
layouts: outlays 
ovals: salvo 
lotta: total 
layout: outlay 
alp: lap pal 
paltry: partly raptly 
alps: laps pals slap 
plats: splat 
palsy: plays splay 
aptly: patly platy 
paul: pula 
lustra: ultras 
sural: urals 
rattly: tartly 
las: sal 
lasts: salts slats 
last: lats salt slat 
talus: tulsa 
salty: slaty 
luaus: usual 
lavs: slav 
awls: laws slaw 
lays: slay 
lav: val 
awl: law 
am: ma 
moan: mona oman 
maroon: romano 
postman: tampons 
manor: norma ramon roman 
manors: ransom romans 
matrons: transom 
mason: moans osman 
masons: samson 
many: myna 
roam: roma 
mayors: morays 
mayor: moray 
amos: soma 
atoms: moats stoma 
atom: moat 
amoy: mayo 
amp: map pam 
pram: ramp 
prams: ramps 
amps: maps spam 
spams: spasm 
stamp: tamps 
arm: mar ram 
arms: mars rams 
marts: smart trams 
swarm: warms 
mart: tram 
amur: arum 
army: mary myra 
mas: sam 
mast: mats tams 
maws: swam 
mays: yams 
mat: tam 
amy: may yam 
ann: nan 
anon: nona 
aprons: parson 
patrons: tarpons 
patron: tarpon 
panto: paton 
arno: nora oran roan rona 
arson: roans 
axons: saxon 
avon: nova 
nap: pan 
suntraps: unstraps 
suntrap: unstrap 
naps: pans snap span 
snaps: spans 
pawns: spawn 
rants: tarns 
rant: tarn 
runway: unwary 
nary: ryan yarn 
ants: stan tans 
aunts: tunas 
antsy: nasty tansy 
awns: sawn swan 
ant: tan 
aunt: tuna 
awn: wan 
any: nay 
apropos: sapporo 
parrots: raptors 
parrot: raptor 
autopsy: payouts 
oars: rosa soar 
assort: roasts 
astor: roast rotas sorta taros 
rota: taro tora 
stoats: toasts 
oats: stoa 
stoat: toast 
oat: tao 
avo: ova 
app: pap 
apps: paps 
par: rap 
pars: raps rasp spar 
rasps: spars 
sprats: straps 
startups: upstarts 
parts: prats sprat strap tarps traps 
startup: upstart 
warps: wraps 
prays: raspy spray 
part: prat rapt tarp trap 
warp: wrap 
asp: pas sap 
pass: saps spas 
pasts: spats 
swaps: wasps 
past: pats spat taps 
sputa: stupa 
pasty: patsy 
paws: swap wasp 
pays: spay yaps 
apt: pat tap 
pay: pya yap 
stars: tsars 
satyrs: strays 
arts: rats star tars tsar 
start: tarts 
surat: sutra 
straw: swart warts 
artsy: satyr stray trays 
raws: wars 
art: rat tar 
ratty: tarty tatry 
arty: tray 
raw: war 
awry: wary 
ayr: ray rya 
stat: tats 
twats: watts 
vast: vats 
swat: twas wast 
saw: was 
sway: ways yaws 
at: ta 
attu: taut 
twat: watt 
way: yaw 
ay: ya 
blobbed: bobbled 
blubbed: bubbled 
blobbing: bobbling 
blubbing: bubbling 
clobber: cobbler 
clobbers: cobblers 
bribed: ribbed 
bombed: mobbed 
dubber: rubbed 
subbed: subdeb 
beriberis: briberies 
rubbishes: rubbishes 
briber: ribber 
bribers: ribbers 
stubbier: subtribe 
lobbers: slobber 
pebbly: plebby 
burbles: lubbers rubbles 
burble: lubber rubble 
bribing: ribbing 
bombing: mobbing 
gibbons: sobbing 
ribbons: robbins 
blubs: bulbs 
blub: bulb 
bourbons: bourbons 
booby: yobbo 
bucked: dubcek 
bounced: buncoed 
beeches: beseech 
susceptibilities: susceptibilities 
butchers: schubert 
buckle: lubeck 
comber: recomb 
bruce: cuber 
cebu: cube 
bouncing: buncoing 
cubist: cubits 
sunblock: unblocks 
curbs: scrub 
betided: debited 
bouldered: redoubled 
disburden: underbids 
bidder: birded 
bed: deb 
buffered: rebuffed 
briefed: debrief 
begrudge: buggered debugger 
belied: edible 
bellied: libeled 
erodible: reboiled 
delibes: edibles 
bendier: inbreed 
delbert: trebled 
buttered: rebutted 
bedew: dweeb 
blogged: boggled 
betiding: debiting 
bugled: bulged 
budges: debugs 
budge: debug 
subsidies: subsidise 
blinder: brindle 
blinders: brindles 
dubliner: unbridle 
bristled: driblets 
builders: rebuilds 
builder: rebuild 
bedim: imbed 
bedims: imbeds 
binder: inbred rebind 
binders: rebinds 
brides: debris rebids 
bedsit: bidets debits 
bidet: debit 
bunked: debunk 
bordello: doorbell 
bordellos: doorbells 
bowlder: lowbred 
bloused: doubles 
blotted: bottled 
blued: lubed 
bedroom: boredom 
bedrooms: boredoms 
sunburned: unburdens 
unburden: unburned 
bounders: rebounds suborned 
bounder: rebound 
burden: burned 
doubters: obtrudes redoubts 
doubter: obtrude redoubt 
beds: debs 
busted: debuts 
debut: tubed 
birdsong: songbird 
bids: dibs 
bod: dob 
bods: dobs 
body: boyd 
buds: dubs 
bud: dub 
beefier: freebie 
breughel: brueghel 
beginner: benigner 
behest: thebes 
impressible: permissible 
lumberers: slumberer 
boneless: noblesse 
obversely: verbosely 
bleep: plebe 
bleeps: plebes 
elbert: treble 
somberness: sombreness 
steuben: subteen 
observes: obverses 
observe: obverse verbose 
bestrew: webster 
beets: beset 
bette: tebet 
buffering: rebuffing 
buffers: rebuffs 
buffer: rebuff 
brief: fiber fibre 
briefs: fibers fibres 
brugge: bugger 
berthing: brighten 
bluegill: gullible 
lumberings: slumbering 
blessing: glibness 
begin: being binge 
bering: binger 
buttering: rebutting 
begins: beings binges 
buglers: burgles 
bugler: burgle 
bugles: bulges 
bugle: bulge 
booger: goober 
boogers: goobers 
publisher: republish 
blushes: bushels 
impressibility: permissibility 
mobilises: omissible 
briskest: briskets 
emboli: mobile 
boilers: reboils 
blisters: bristles 
blister: bristle 
timbers: timbres 
resubmit: terbiums 
timber: timbre 
erbium: imbrue 
tribunes: turbines 
bittern: britten 
tribune: turbine 
bier: brie 
biers: bries 
bestir: biters 
bustier: rubiest 
bruise: buries busier rubies 
tiber: tribe 
berk: kerb 
berks: kerbs 
bellows: boswell 
somberly: sombrely 
stumbler: tumblers tumbrels 
lumbers: rumbles slumber 
tumbler: tumbrel 
lumber: rumble 
stumble: tumbles 
nobel: noble 
sunbelt: unblest 
bole: lobe 
bolsters: lobsters 
bolster: lobster 
blotters: bottlers 
blowers: bowlers 
blotter: bottler 
blower: bowler 
boles: lobes 
blouses: boluses 
blouse: boules obelus 
bowels: elbows 
below: bowel elbow 
bluster: bustler butlers subtler 
elbrus: rubles 
bluer: rubel ruble 
bustles: sublets 
belts: blest 
bluest: bluets bustle sublet subtle 
blues: lubes 
blue: lube 
somber: sombre 
mobsters: sombrest 
besoms: emboss 
ben: neb 
benton: bonnet 
bone: ebon 
boner: borne 
breton: bronte 
bourne: unrobe 
boney: ebony 
brunet: bunter 
booster: reboots 
boer: bore ebro 
bores: robes sober 
sorbets: strobes 
sorbet: strobe 
bowers: browse 
bosses: obsess 
brutes: buster rebuts tubers 
rebus: rubes 
bert: bret 
brute: buret rebut tuber 
best: bets 
betsy: bytes 
beys: byes 
bute: tube 
bey: bye 
blogging: boggling 
bugling: bulging 
stumbling: tumblings 
blotting: bottling 
blowing: bowling 
bluing: lubing 
boring: robing 
bingos: gibson 
busings: bussing 
busting: tubings 
blog: glob 
blogs: globs 
bog: gob 
bogs: gobs 
burgs: grubs 
burg: grub 
borsht: broths throbs 
broth: throb 
bosh: hobs 
brush: shrub 
bush: hubs 
mbini: nimbi 
biko: kibo 
sibyl: sybil 
bin: nib 
bins: nibs 
bio: ibo obi 
bistro: orbits 
bios: obis 
bris: ribs 
bonk: knob 
bonks: knobs 
book: kobo 
brusk: burks 
lobs: slob 
blots: bolts 
blows: bowls 
blot: bolt 
blow: bowl 
blurs: burls 
blur: burl 
booms: bosom 
boons: boson 
born: brno 
bourn: bruno 
byron: robyn 
nobs: snob 
bonus: bosun 
brunt: burnt 
buns: nubs snub 
bun: nub 
boost: boots 
bro: orb rob 
bros: orbs robs 
robust: turbos 
bows: swob 
boys: yobs 
boy: yob 
burs: rubs 
brut: burt 
bur: rub 
bury: ruby 
busts: stubs 
buss: subs 
bust: buts stub tubs 
bus: sub 
busy: buys 
but: tub 
crescentic: eccentrics 
checkered: rechecked 
concerted: concreted 
constructed: deconstruct 
centerpieces: centrepieces 
centerpiece: centrepiece 
checkering: rechecking 
egocentric: geocentric 
checker: recheck 
checkers: rechecks 
creches: screech 
cervices: crevices 
countercultures: countercultures 
connecters: reconnects 
connecter: reconnect 
concerting: concreting 
chicle: cliche 
chicles: cliches 
choice: echoic 
choices: cochise 
crochets: crotches 
circle: cleric 
circles: clerics 
cecily: cicely 
conciser: cornices 
concerti: necrotic 
constructer: reconstruct 
citric: critic 
cockily: colicky 
comics: cosmic 
crocus: occurs succor 
decreed: receded 
decide: deiced 
discerned: rescinded 
uncredited: undirected 
decider: decried 
deciders: descried 
credited: directed 
deduces: seduced 
deduce: educed 
deductions: discounted 
coddles: scolded 
deduct: ducted 
discreetnesses: discretenesses 
indirectnesses: indiscreetness 
rediscoveries: rediscoveries 
directnesses: discreetness discreteness 
deceiver: received 
deselect: selected 
predecessor: reprocessed 
creeped: precede 
respected: sceptered 
excepted: expected 
decree: recede 
decrees: recedes 
resected: secreted 
certified: rectified 
centerfolds: centrefolds 
centerfold: centrefold 
genocides: genocides 
congested: decongest 
ciphered: decipher 
indiscreetly: iridescently 
indiscreet: iridescent 
declension: indolences 
decliner: reclined 
declines: licensed silenced 
discreetly: discretely 
discoverers: rediscovers 
discoverer: rediscover 
decrepit: depicter 
directer: redirect 
decries: deicers 
discreet: discrete 
directest: trisected 
certitudes: certitudes rectitudes 
certitude: rectitude 
commender: recommend 
decomposer: recomposed 
compressed: decompress 
denouncer: renounced 
encoder: encored 
censored: encoders seconder 
conserved: conversed 
countered: recounted 
descent: scented 
procedures: reproduces 
procedure: reproduce 
recorder: rerecord 
recorders: rerecords 
corseted: escorted 
ceder: creed 
ceders: creeds screed 
reduces: rescued secured seducer 
deuces: educes seduce 
deuce: educe 
discerning: rescinding 
crediting: directing 
consigned: seconding 
choked: hocked 
chunder: churned 
chowders: cowherds 
chowder: cowherd 
cedi: dice iced 
indirections: indiscretion 
commissioned: decommission 
conditioners: reconditions 
conditioner: recondition 
description: predictions 
directions: discretion 
cretinoid: direction 
distincter: interdicts 
indicter: indirect 
incised: indices 
crudities: diuretics 
deistic: diciest 
dickens: snicked 
compiled: complied 
includes: unsliced 
include: nuclide 
coiled: docile 
docetism: domestic 
continued: unnoticed 
codein: coined 
discounter: introduces rediscount reductions 
introduce: reduction 
seduction: suctioned 
cinders: discern rescind 
discerns: rescinds 
incudes: induces 
creditors: directors recordist 
creditor: director 
discover: divorces 
predicts: scripted 
cider: cried dicer riced 
credits: directs 
crudites: curtsied 
credit: direct 
cited: edict 
vedic: viced 
corked: docker rocked 
dockets: stocked 
condoles: consoled 
curdle: curled 
code: coed 
procured: producer 
coder: cored credo decor 
corder: record 
coders: credos decors scored 
coursed: scoured sourced 
codes: coeds 
codex: coxed 
crudest: crusted 
crudes: cursed 
cyders: descry 
crude: cured 
cyder: decry 
chords: schrod 
jurisdictions: jurisdictions 
lucid: ludic 
conduits: discount 
cupids: cuspid 
clod: cold 
clods: colds scold 
cloud: could 
condor: cordon 
condors: cordons 
cod: doc 
cords: scrod 
cods: docs 
cruds: curds 
crud: curd 
cuds: scud 
impertinences: impertinences 
electives: selective 
centimeters: centimetres 
centimeter: centimetre 
epicenters: epicentres 
epicenter: epicentre 
perceptive: preceptive 
cementers: cerements 
cementer: cerement 
senescent: sentences 
rescreen: screener 
recenter: terrence 
chiefest: fetiches 
imperfections: perfectionism 
certifier: rectifier 
certifies: rectifies 
frenetic: reinfect 
fierce: recife 
conferer: confrere enforcer 
confreres: enforcers 
perfects: prefects 
perfect: prefect 
egocentrism: geocentrism 
congeries: recognise 
excepting: expecting 
congreve: converge 
kitchener: thickener 
sketchiness: thicknesses 
chenille: hellenic 
helices: lichees 
chestier: heretics 
chestiest: esthetics 
sepulchers: sepulchres 
sepulcher: sepulchre 
chessmen: mensches 
schemer: schmeer 
retrench: trencher 
cohere: echoer reecho 
cheeps: speech 
cheers: escher 
chester: etchers retches 
insolvencies: insolvencies 
centiliters: centilitres 
centiliter: centilitre 
elections: selection 
licenser: reclines silencer 
license: silence 
licenses: silences 
cruelties: cutleries 
clevises: vesicles 
micrometers: micrometres 
micrometer: micrometre 
economies: economise 
ecumenist: intumesce 
reconnoiters: reconnoitres 
reconnoiter: reconnoitre 
incenses: niceness 
counterspies: persecutions 
resections: secretions 
erections: resection secretion 
erection: neoteric 
prescient: reinspect 
insecure: sinecure 
enteric: enticer 
evince: venice 
coteries: esoteric 
pierce: recipe 
preciser: reprices 
pierces: precise recipes 
precisest: tricepses 
pieces: specie 
scleroses: scoreless 
electors: selector 
cureless: recluses 
cruelest: lectures 
elects: select 
compeer: compere 
compeers: comperes 
conquerer: reconquer 
converters: reconverts 
converter: reconvert 
conserves: converses 
conserve: converse 
conveyer: reconvey 
centers: centres 
center: centre recent 
recrosses: sorceress 
recourses: resources 
erectors: secretor 
recourse: resource 
percept: precept 
creep: crepe 
creeps: crepes 
respects: scepters sceptres specters spectres 
respect: scepter sceptre specter spectre 
creepy: crepey 
excepts: expects 
except: expect 
rescuer: securer 
ceres: scree 
recess: screes 
rescues: secures 
erects: resect secret 
cereus: recuse rescue secure 
crete: erect 
coiffeur: coiffure 
coffers: scoffer 
certifying: rectifying 
configures: refocusing 
chief: fiche 
chiefly: chifley 
chiefs: fiches 
fetich: fichte 
fickler: flicker 
conifers: forensic 
certify: rectify 
pocketfuls: pocketsful 
forces: fresco 
licensing: silencing 
piercings: precising 
contenting: contingent 
censoring: consigner reconsign 
conserving: conversing 
countering: recounting 
resourcing: scroungier 
corseting: escorting 
coveting: vietcong 
rescuing: securing 
homiletics: mesolithic 
ethicist: itchiest theistic 
kitchens: thickens 
kitchen: thicken 
kirsches: kirsches 
thickest: thickets thickset 
chillers: schiller 
phenolic: pinochle 
chlorite: clothier 
chiles: chisel 
chine: niche 
phrenic: pincher 
chines: inches niches 
ethnics: sthenic 
coheir: heroic 
chorister: rhetorics 
coheirs: heroics 
erich: reich 
restitch: stitcher 
ethics: itches 
chokers: shocker 
chemos: schmoe 
chutneys: chutneys 
ocherous: ochreous 
porches: porsche 
cheops: epochs 
chore: ocher ochre 
chores: ochers ochres 
hectors: torches 
hector: troche 
chose: echos 
chert: retch 
chest: techs 
chesty: scythe 
echt: etch tech 
continuities: continuities 
toxicities: toxicities 
ickiness: kinesics 
commissioner: recommission 
commissioners: recommissions 
eroticisms: isometrics 
eroticism: isometric 
comities: semiotic 
inconsistent: nonscientist 
inceptions: inspection 
scrutinies: scrutinise sinecurist 
citrine: inciter 
iciness: incises 
cities: iciest 
corklike: rocklike 
clinker: crinkle 
clinkers: crinkles 
stickler: ticklers trickles 
tickler: trickle 
misreckon: monickers 
nickers: snicker 
rockiest: stockier 
pickets: skeptic 
rickets: sticker tickers 
crikey: rickey 
completions: completions 
compile: polemic 
compiles: complies polemics 
colonies: colonise 
cornelius: inclosure reclusion 
exclusions: exclusions 
pencils: splenic 
clients: stencil 
cloister: costlier 
clipper: cripple 
clippers: cripples 
relics: slicer 
celsius: sluices 
economist: emoticons 
consumerists: misconstrues 
consumerist: misconstrue 
competitor: optometric 
ceriums: murices 
cerium: uremic 
cesiums: miscues 
cesium: miscue 
cine: nice 
centurion: continuer 
percussion: supersonic 
cornier: corrine 
coiners: cronies ericson 
ericsson: necrosis 
countries: cretinous neurotics 
conies: cosine 
cession: cosines 
cessions: cosiness 
notices: section 
noetic: notice 
pincer: prince 
pincers: princes 
inspect: pectins 
cistern: cretins 
incests: insects 
incest: insect nicest 
corries: crosier 
coexist: exotics 
epic: pice 
cripes: precis prices 
epics: spice 
pisces: spices 
cire: eric 
criers: ricers 
cruisers: scurries 
critters: restrict stricter 
crustier: recruits 
cruiser: curries 
cries: rices 
citruses: curtsies 
cursives: scurvies 
cruise: curies 
civets: evicts 
civet: evict 
jounces: juncoes 
conker: reckon 
conkers: reckons 
cooker: recook 
cookers: recooks 
corker: rocker 
corkers: rockers 
restock: rockets 
pecks: speck 
colones: console 
consoles: coolness 
counsel: unclose 
cleo: cole 
colorer: recolor 
coolest: ocelots 
closeup: couples 
clover: velcro 
closest: closets 
cluster: cutlers 
lucres: ulcers 
cruelty: cutlery 
cruel: lucre ulcer 
cutlets: scuttle 
clue: luce 
costumers: customers 
costumer: customer 
comet: comte 
crumpets: spectrum 
cone: once 
coroner: crooner 
coroners: crooners 
corners: scorner 
censor: crones recons 
construe: counters recounts trounces 
counter: recount trounce 
cones: onces scone 
contuses: countess 
curtness: encrusts 
cents: scent 
coopers: scooper 
courteous: outsource 
coyote: oocyte 
precursor: procurers 
corpses: process 
prescott: protects 
copes: copse pecos scope 
copses: scopes 
corers: scorer 
crosser: recross scorers 
coursers: scourers 
courser: scourer 
cores: score 
corsets: escorts sectors 
courses: croesus sources sucrose 
corset: cortes escort rectos sector 
coverts: vectors 
course: source 
cowers: escrow 
covert: vector 
corey: coyer royce 
pecs: spec 
curers: recurs 
curer: recur 
cruses: curses 
certs: crest 
curtest: cutters 
cruets: custer eructs truces 
cruse: cures curse ecrus sucre 
crews: screw 
cruet: cuter eruct recut truce 
cure: ecru 
cutesy: cuteys 
cues: ecus 
cue: ecu 
cuffs: scuff 
frictions: frictions 
confusions: confusions 
coif: foci 
ficus: sufic 
cupfuls: cupsful 
choking: hocking 
lickings: slicking 
sticking: tickings 
cognitions: incognitos 
cognition: incognito 
corking: rocking 
cowlings: scowling 
cummings: scumming 
gnomonic: oncoming 
coming: gnomic 
copings: scoping 
coursing: scouring sourcing 
costing: gnostic 
histrionics: trichinosis 
kitsch: shtick thicks 
chin: inch 
chopin: phonic 
choir: ichor 
chit: itch 
chivy: vichy 
hock: koch 
hocks: shock 
chylous: slouchy 
churl: lurch 
chum: much 
nonsuch: sunchon 
couth: touch 
cush: such 
nitpicks: stickpin 
cotillion: octillion 
sciolist: solicits 
colitis: solicit 
licks: slick 
nicks: snick 
stickup: upticks 
stick: ticks 
coil: loci 
cyril: lyric 
monotypic: toponymic 
moronic: omicron 
crimson: microns 
crimps: scrimp 
cion: coin icon 
coins: icons scion sonic 
scions: sonics 
consist: tocsins 
tocsin: tonics 
ontic: tonic 
incur: runic 
pictor: tropic 
optics: picots topics 
optic: picot topic 
crisp: scrip 
crisps: scrips 
pics: spic 
curtiss: rustics 
citrus: curtis rictus rustic 
mocks: smock 
pocks: spock 
cork: kroc rock 
corks: rocks 
corky: rocky 
struck: trucks 
stuck: tucks 
culls: scull 
clumsy: muscly 
cool: loco 
cools: locos 
clots: colts 
clouts: locust 
cowls: scowl 
clot: colt 
cums: scum 
coupons: soupcon 
contours: croutons 
contour: crouton 
corns: scorn 
corny: crony 
counts: tucson 
cnut: cunt 
coop: poco 
coops: scoop 
coots: scoot 
corps: crops 
corpus: croups 
cor: orc 
costs: scots 
cost: cots scot 
cows: scow 
cups: cusp 
crust: curst 
crusty: curtsy 
diddle: lidded 
diddler: riddled 
deified: edified 
defiled: fielded 
defend: fended 
refunded: underfed 
deeding: deigned 
demised: misdeed 
denied: indeed 
indented: intended 
underside: undesired 
derides: desired resided 
dieted: edited 
meddle: melded 
moldered: remolded 
mouldered: remoulded 
delude: dueled eluded 
demurred: murdered 
depend: pended 
dresden: reddens 
dented: tended 
denude: duende dundee endued 
deposed: seedpod 
fodder: forded 
drugged: grudged 
gilded: glided 
deluding: indulged 
girdled: griddle 
girded: ridged 
grounded: underdog 
dunged: nudged 
huddler: hurdled 
dioxides: oxidised 
spindled: splendid 
dwindles: swindled 
dreidl: riddle 
diluted: luddite 
midden: minded 
dowdiness: downsides 
disowned: downside 
didoes: diodes 
devoid: voided 
dried: redid 
doodler: drooled 
redound: rounded 
dyed: eddy 
deferment: fermented 
feeder: reefed 
deferrer: referred 
energised: reseeding 
greened: reneged 
wheedle: wheeled 
deliverers: redelivers 
deliverer: redeliver 
intervened: reinvented 
tenderise: teredines 
dewinesses: widenesses 
expediters: preexisted 
lessened: needless 
developers: redevelops 
developer: redevelop 
leered: reeled 
levered: reveled 
deletes: sleeted steeled 
demeter: metered 
repented: repetend 
evened: vendee 
deeper: peered 
deepest: steeped 
reserved: reversed 
reseed: seeder 
reseeds: seeders 
deserve: severed 
resewed: weeders 
reeved: veered 
forefend: offender 
deffer: reffed 
feeding: feigned 
friendlies: infielders 
feminised: misdefine 
edifiers: fireside 
deifies: edifies 
defiler: fiedler fielder refiled 
defilers: fielders 
definer: refined 
dessertspoonfuls: dessertspoonsful 
deflower: flowered 
performed: preformed 
deforest: forested fostered 
defer: freed 
edge: geed 
jiggered: rejigged 
heeding: neighed 
ingredients: tenderising 
predigestion: redepositing 
reediting: reignited 
gelidness: seedlings 
designer: redesign resigned 
designers: redesigns 
diverge: grieved 
ledges: sledge 
geode: ogeed 
reorged: rogered 
edger: greed 
edgers: greeds 
greedy: greyed 
edges: sedge 
relished: shielder 
dethrones: shortened 
dentistries: disinterest 
sensitised: tidinesses 
densities: destinies 
redline: relined 
idleness: linseeds 
enlisted: listened tinseled 
periled: replied 
lieder: relied 
delivers: silvered slivered 
deliver: relived reviled 
diesel: elides 
eyelids: seedily 
levied: veiled 
immersed: simmered 
domineers: modernise 
modernises: sermonised 
modernizes: sermonized 
midwestern: stemwinder 
premised: simpered 
demerits: demister 
demerit: merited mitered 
rowdinesses: wordinesses 
dnieper: repined ripened 
denier: nereid reined 
interred: trendier 
deniers: resined 
dissenter: residents tiredness 
dniester: inserted nerdiest resident trendies 
denies: denise seined 
dewiness: wideness 
dinettes: insetted 
endwise: sinewed 
endive: envied veined 
overdrives: overdrives 
reprised: respired 
despiser: disperse presides 
deputies: deputise 
desirer: dreiser resider 
retired: retried tireder 
rewired: weirder 
desire: eiders reside 
desires: resides 
editress: resisted 
reissued: residues 
dieters: reedits 
derives: deviser diverse revised 
dieter: reedit retied tiered 
devise: sieved 
demerol: modeler remodel 
modelers: remodels 
lenders: slender 
exploder: explored 
delores: resoled 
lowered: roweled 
devolve: evolved 
preludes: repulsed 
deeply: yelped 
dueler: eluder 
lewder: welder 
deem: mede meed 
demote: emoted 
permed: premed 
demurrers: murderers 
demurrer: murderer 
demurest: mustered 
deems: meeds 
eden: need 
endnote: tenoned 
ponderers: responder 
doreen: redone 
suspender: unpressed 
denser: sender 
redness: senders 
endures: ensured 
rented: tender 
denture: tenured 
endure: enured 
denver: nerved vender 
dense: needs 
nested: tensed 
endues: ensued 
netted: tented 
overdoes: overdose 
orderer: reorder 
resorted: restored 
erodes: redoes 
devote: vetoed 
deep: peed 
depress: pressed 
erupted: reputed 
deeps: speed 
deer: reed 
dresser: redress 
deers: reeds seder 
desserts: stressed 
deserts: dessert 
desert: deters rested 
strewed: wrested 
served: versed 
deter: treed 
redye: reedy 
detest: tested 
stewed: tweeds 
sewed: swede weeds 
desex: sexed 
dewey: weedy 
def: fed 
differ: riffed 
offends: sendoff 
duffer: ruffed 
dignifies: signified 
defiling: fielding 
deifying: edifying 
fidget: gifted 
fiendish: finished 
infidel: infield 
infidels: infields 
finked: knifed 
field: filed flied 
flirted: trifled 
fiend: fined 
finder: friend 
finders: friends 
fired: fried 
deify: edify 
enfold: fondle 
enfolds: fondles 
flooder: floored 
folder: refold 
folders: refolds 
flowed: fowled wolfed 
deform: formed 
deforms: serfdom 
founder: refound 
defrost: frosted 
feuds: fused 
gelding: niggled 
geldings: sledging 
digger: rigged 
dogleg: logged 
doglegs: slogged 
grudge: rugged 
delights: slighted 
delight: lighted 
impeding: impinged 
indenting: intending 
destining: indigents 
desiring: residing ringside 
rigidness: ringsides 
dieting: editing ignited 
gelid: glide 
melding: mingled 
goldmine: modeling 
moldering: remolding 
mouldering: remoulding 
goldmines: modelings 
longitudes: ungodliest 
dingles: singled 
glinted: tingled 
dueling: eluding indulge 
gloried: godlier 
gilder: girdle glider regild 
gilders: girdles gliders 
guilders: sludgier 
demurring: murdering 
midges: smidge 
ending: ginned 
grinned: rending 
undersigns: undressing 
sundering: undersign 
endings: sending 
denting: tending 
eroding: ignored negroid redoing 
wendigo: widgeon 
grinders: regrinds 
deigns: design 
signed: singed 
dirges: ridges 
dongle: golden longed 
gulden: lunged 
lodge: ogled 
glossed: godless 
grounder: reground 
guerdon: undergo 
drogues: gourdes groused 
drogue: gourde rouged 
hide: hied 
disinherit: rhinitides 
dishonest: hedonists 
hider: hired 
dhurrie: hurried 
dervish: shrived 
swedish: swished 
whited: withed 
hurdle: hurled 
dehorn: horned 
enshroud: unhorsed 
hooped: poohed 
herod: horde 
hordes: horsed rhodes shored 
hosed: shoed 
herds: sherd shred 
sherds: shreds 
distiller: redistill 
delimit: limited 
doilies: idolise 
dentitions: distention tendonitis 
deposition: positioned 
iodines: ionised 
editions: sedition 
dirtiness: disinters 
indies: inside 
insisted: tidiness 
disunite: nudities 
riptides: spirited 
dirties: ditsier 
kilned: kindle linked 
kindles: slinked 
dikes: skied 
deli: idle lied 
lilted: tilled 
mildness: mindless 
dimple: limped 
misled: smiled 
delusion: unsoiled 
spindle: splined 
swindles: wildness windless 
insulted: unlisted 
lindsey: snidely 
oiled: oldie 
despoil: dipoles 
soldier: solider 
oldies: soiled 
dissolute: solitudes 
piled: plied 
dispel: lisped 
idler: riled 
idlers: slider 
delis: idles sidle slide 
sidles: slides 
idlest: listed silted tildes 
dilutes: duelist 
tilde: tiled 
tilted: titled 
devil: lived 
wield: wilde wiled 
dewily: widely wieldy 
dime: idem 
dimmer: rimmed 
midterm: trimmed 
dummies: mediums 
denim: mined 
dominoes: monodies 
demotion: motioned 
minder: remind 
minders: reminds 
dimness: missend 
sodomies: sodomise 
moodiest: sodomite 
dumpier: umpired 
mired: rimed 
deism: dimes 
deisms: missed 
demist: misted 
demit: timed 
dine: enid 
dennis: sinned 
dentins: indents intends 
dentin: indent intend tinned 
poisoned: poseidon 
opined: ponied 
indore: ironed 
indorse: ordines rosined 
rowdiness: wordiness 
edison: noised onside 
diners: rinsed snider 
insureds: sundries 
strident: tridents 
rewinds: winders 
intrude: untired untried 
inured: ruined 
rewind: winder 
denis: dines snide 
dissent: snidest 
dentist: stinted 
density: destiny 
indues: undies 
disney: sidney snidey 
united: untied 
edwin: widen wined 
index: nixed 
depositor: droopiest 
dopier: period 
disposer: dropsies 
disprove: provides 
deposits: topsides 
deposit: dopiest posited topside 
rowdier: wordier worried 
editors: sortied steroid storied 
rowdiest: wordiest 
devisor: visored 
dowries: rowdies weirdos 
editor: rioted 
detroit: dottier 
devoir: voider 
outside: tedious 
pride: pried 
prides: prised spider 
disputer: stupider 
direr: drier 
reid: ride 
driers: riders 
stirred: strider 
dries: rides sired 
direst: driest stride 
diverts: strived 
divers: drives 
tired: tried 
diver: drive rived verdi 
weird: wider wired 
dies: ides side 
deists: desist 
disuse: issued 
deist: diets edits sited tides 
duties: suited 
dives: vised 
diet: edit tide tied 
dewitt: witted 
devi: dive vide vied 
dykes: skyed 
drollest: strolled 
molder: remold 
molders: remolds smolder 
moulders: remoulds smoulder 
moulder: remould 
models: seldom 
lumped: plumed 
loden: olden 
splendors: splendors 
splendours: splendours splendrous 
dole: lode olde 
looped: poodle pooled 
poodles: spooled 
loosed: oodles soloed 
looted: toledo tooled 
elwood: wooled 
resold: solder 
louder: loured 
delos: doles lodes soled 
loudest: tousled 
loused: souled 
dowels: slowed 
dowel: lowed 
duple: puled 
rustled: strudel 
lured: ruled 
duels: slued 
lewd: weld 
demo: dome edom mode 
moored: roomed 
demos: domes modes 
mused: sedum 
den: end ned 
denton: tendon 
dunnest: stunned 
done: node 
snooped: spooned 
ponders: respond 
drone: ronde 
drones: snored 
dourness: resounds sounders 
rodents: snorted 
roundest: tonsured unsorted 
resound: sounder 
downers: wonders 
downer: wonder 
rodney: yonder 
edson: nodes nosed 
endows: snowed 
noted: toned 
endow: owned woden 
dozen: zoned 
prudent: uptrend 
pends: spend 
nerd: rend 
nerds: rends 
sunders: undress 
nursed: sunder 
nuder: under 
dens: ends send 
dents: tends 
student: stunted 
dunes: nudes 
dent: tend 
dune: nude 
doe: ode 
torpedo: trooped 
dope: oped 
doper: pedro pored roped 
dopers: spored 
deports: sported 
postured: proudest sprouted 
deport: ported 
dopes: posed 
depots: despot posted 
pseudo: souped 
depot: opted 
doer: dore oder redo rode 
dourer: ordure 
dossers: drosses 
dowsers: drowses 
dorset: doters sorted stored strode 
detours: dourest rousted 
douser: roused soured 
dowers: dowser drowse 
dotter: rotted 
detour: routed toured 
dover: drove roved 
dower: rowed 
does: dose odes 
douses: soused 
dotes: odets 
dowse: sowed 
dote: toed 
drupes: dupers prudes pursed 
pursued: usurped 
drupe: duper prude 
dupes: pseud 
durer: ruder 
derry: dryer 
dusters: trussed 
duster: rudest rusted 
rude: rued 
dues: duse sued used 
dews: weds 
dew: wed 
dewy: edwy 
foundling: unfolding 
fondus: founds 
fondu: found 
drugging: grudging 
gilding: gliding 
gildings: glidings 
girding: ridging 
golding: lodging 
dunging: nudging 
dishing: hidings hidings shindig 
sidling: sliding 
ingrid: riding 
dignity: tidying 
domingo: dooming 
sounding: undoings 
dingo: doing 
drowsing: wordings 
doings: dosing 
dingy: dying 
gird: grid 
girds: grids 
gordon: grodno 
dog: god 
dogs: gods 
humidors: rhodiums 
humidor: rhodium 
holdups: upholds 
holdup: uphold 
hounds: hudson unshod 
doh: hod 
dohs: dosh hods shod 
dilutions: dilutions 
nudnik: unkind 
disk: kids 
dilly: idyll 
idol: lido 
rowdily: wordily 
idols: lidos solid 
lids: sild slid 
idly: idyl 
dim: mid 
odiums: sodium 
nodi: odin 
upwind: windup 
nudity: untidy 
disport: tripods 
torpid: tripod 
ovid: void 
quids: squid 
dis: ids 
drolly: lordly 
dolly: lloyd 
lowdowns: slowdown 
dolor: drool 
dolors: drools 
olds: sold 
dolt: told 
loud: ludo 
loyd: oldy 
doom: mood 
woodworms: wormwoods 
woodworm: wormwood 
dooms: moods sodom 
downturn: turndown 
don: nod 
donor: rondo 
donors: rondos 
rotund: untrod 
dons: nods 
nodus: sound 
doorposts: doorstops 
doorpost: doorstop 
door: odor ordo rood 
doors: odors roods 
douro: odour 
drop: prod 
drops: prods 
sword: words 
dowry: rowdy wordy 
dost: dots 
puds: spud 
durst: turds 
dusts: studs 
dust: stud 
dusty: study 
impressivenesses: permissivenesses 
restrengthens: strengtheners 
restrengthen: strengthener 
energies: energise 
greene: renege 
greener: reneger 
esthete: teethes 
impressiveness: permissiveness 
entireties: eternities 
evilnesses: vilenesses 
enlistee: selenite 
relievers: revelries 
leeriest: sleetier steelier 
sleetiest: steeliest 
ernestine: internees 
interpreters: reinterprets 
interpreter: reinterpret 
enterprises: intersperse 
repertoires: repertories 
steelworker: teleworkers 
oversleeps: sleepovers 
oversleep: sleepover 
peelers: sleeper 
peerless: sleepers 
levees: sleeve 
overseen: veronese 
presenters: represents 
presenter: represent 
preteens: pretense 
reenter: terrene 
evener: veneer 
sweetness: wetnesses 
perverse: preserve 
sweeper: weepers 
reserves: reverses 
reserve: reveres reverse severer 
reeves: severe 
forfeitures: forfeitures 
jeffery: jeffrey 
feeling: fleeing 
feigner: freeing reefing 
fleshlier: shellfire 
fresher: refresh 
freshest: freshets 
infertile: interfile 
feistier: fieriest 
feistiest: testifies 
liefer: refile relief 
filterer: refilter 
refiles: reliefs 
lefties: liefest 
fernier: refiner 
ferniest: infester 
putrefies: stupefier 
feel: flee 
ferules: refuels 
ferule: fueler refuel 
feels: flees 
fettles: leftest 
forewent: freetown 
foresters: reforests 
forester: reforest 
free: reef 
freer: refer 
frees: reefs 
fester: freest 
feet: fete 
greening: reneging 
lighteners: sheltering 
lengthier: lightener 
ethologies: theologies 
greenish: sheering 
tethering: tightener 
seething: sheeting 
inveigler: relieving 
intervening: reinventing 
keening: kneeing 
keeping: peeking 
grenville: revelling 
peelings: sleeping 
leering: reeling 
letterings: resettling 
levering: reveling 
gentiles: sleeting steeling 
eulogies: eulogise 
metering: regiment 
meeting: teeming 
emigre: regime 
emigres: regimes 
ingenues: unseeing 
genuine: ingenue 
presetting: pretesting 
reserving: reversing 
synergies: synergies 
gentries: integers steering 
resetting: retesting 
integer: treeing 
reeving: veering 
genies: seeing 
regisseur: surgeries 
grieve: regive 
genre: green 
genres: greens 
energy: greeny 
genet: tenge 
egrets: greets 
egret: greet 
homeliest: lithesome 
nephrite: trephine 
herein: inhere 
resynthesis: synthesiser 
neither: therein 
theories: theorise 
rehires: sherrie 
polythene: telephony 
reupholsters: upholsterers 
reupholster: upholsterer 
horseless: shoreless 
helves: shelve 
ethel: lethe 
homeowners: horsewomen 
hermes: shmeer 
honester: hortense 
nowhere: whereon 
howsoever: whosoever 
hereto: hetero 
however: whoever 
herpes: sphere 
here: rhee 
heres: sheer 
esther: ethers hester theres threes 
hewers: wheres 
ether: there three 
hewer: where 
sheets: theses 
sheet: these 
millimeters: millimetres 
millimeter: millimetre 
solemnities: solemnities 
impressively: permissively 
impressive: permissive 
einstein: nineties 
petitioners: repetitions 
petitioner: repetition 
jennie: jinnee 
kilometers: kilometres 
kilometer: kilometre 
ellipses: pileless 
limestones: milestones 
limestone: milestone 
limpnesses: simpleness 
interlopes: repletions 
interlope: repletion 
lionesses: noiseless 
penlites: plenties 
listeners: reenlists 
leinster: listener reenlist silenter 
ensile: senile 
evilness: vileness 
lisente: tensile 
peristyle: priestley 
pulverise: repulsive 
perlite: reptile 
revilers: silverer 
leviers: relives reviles servile 
eviler: levier relive revile 
elise: elsie 
elites: listee 
memories: memorise 
nemesis: siemens 
empire: premie 
premiers: simperer 
impresser: reimpress 
empires: premise 
impresses: premisses 
merriest: triremes 
emitters: termites 
emitter: termite 
puninesses: supineness 
inverness: nerviness 
intenser: internes 
isoprene: pioneers 
perviousness: previousness 
entropies: interpose 
reversions: reversions 
orneriest: reorients 
persistent: pinsetters prettiness 
pensive: vespine 
ernie: irene 
reinsert: terrines 
reinter: rentier terrine 
nervier: vernier 
interests: triteness 
retinues: reunites 
nerviest: reinvest 
newsier: wieners 
entirety: eternity 
retinue: reunite uterine 
envier: venire 
roisterers: terrorises 
roisterer: terrorise 
peppier: preppie 
reprise: respire 
reprises: respires 
preterit: prettier 
esquire: queries 
quieter: requite 
eire: erie 
retires: retries terries 
series: sirees 
testier: trieste 
restive: veriest 
reviews: viewers 
review: viewer 
jeer: jere 
eek: eke 
keel: klee leek 
keels: leeks sleek 
keen: knee 
keynotes: keystone 
keens: knees 
evoker: revoke 
keep: peek peke 
keeps: peeks pekes 
ekes: seek 
eel: lee 
respell: speller 
respells: spellers 
resell: seller 
resells: sellers 
retells: tellers 
retell: teller 
employers: reemploys 
employer: reemploy 
pelmets: temples 
pelmet: temple 
elmer: merle 
remelts: smelter 
lenore: lorene 
nestler: relents 
lenses: lessen 
nettle: telnet 
evelyn: evenly 
polyesters: proselytes 
polyester: proselyte 
peel: pele 
leper: repel 
lepers: repels 
petrels: respelt 
peels: sleep 
leer: reel 
leers: reels 
settlers: trestles 
swelters: wrestles 
seltzers: seltzers 
letters: settler trestle 
swelter: welters wrestle 
restyle: tersely 
elvers: levers revels 
elver: lever revel 
eels: else lees 
sleets: steels 
selves: vessel 
sleet: steel stele 
sleety: steely 
menes: mesne semen 
menses: semens 
enemy: yemen 
meteors: remotes 
emoter: meteor remote 
presume: supreme 
merest: meters metres 
meter: metre 
meets: metes teems 
meet: mete teem 
rennets: tenners 
rennet: tenner 
opener: reopen 
openers: reopens 
serpens: spenser 
pertness: presents serpents 
present: repents serpent 
peens: penes 
erne: rene 
renters: sterner 
enters: ernest resent sterne tenser 
neuters: tenures tureens 
ensure: enures 
nerves: severn 
renews: resewn 
neuter: retune tenure tureen 
nerve: never verne 
newer: renew 
seen: sene 
essen: sense 
sente: teens tense 
events: steven 
evens: seven 
exporters: reexports 
exporter: reexport 
espressos: repossess 
espouser: repousse 
orestes: stereos 
oeuvres: overuse 
peer: pere 
presser: repress 
putterers: sputterer 
peers: spree 
pesters: presets 
perseus: peruses 
pester: peters preset 
pertest: pretest 
peruse: purees rupees 
puree: rupee 
pees: seep 
sweep: weeps 
quester: request 
rester: terser 
revers: server 
erse: seer sere 
esters: resets serest steers 
retests: setters streets tersest testers 
serves: severs verses 
resews: sewers 
ester: reset steer stere terse trees 
retest: setter street tester 
serve: sever veers verse 
ewers: resew sewer weser 
texture: urtexte 
ever: veer 
ewer: weer were 
eery: eyer 
sestet: testes tsetse 
essex: sexes 
sweet: weest 
ewes: wees 
ewe: wee 
fief: fife 
fifties: iffiest 
fitfulness: snuffliest 
fiefs: fifes 
fretful: truffle 
firelight: flightier 
fighters: freights 
fighter: freight refight 
infringe: refining 
inferring: infringer 
performing: preforming 
foresting: fostering 
finger: fringe 
fingers: fringes 
gunfires: refusing 
forge: gofer 
forges: gofers 
finisher: refinish 
fetishist: shiftiest 
flemish: himself 
furnisher: refurnish 
fortieths: frothiest 
flesh: shelf 
felinity: finitely 
file: leif lief life 
filler: refill 
fillers: refills 
loftier: trefoil 
filer: flier lifer rifle 
filers: fliers lifers rifles 
filters: lifters trifles 
filter: lifter 
files: flies 
filets: fliest itself stifle 
firestorms: reformists 
firestorm: reformist 
finer: infer 
fitness: infests 
feints: finest infest 
firer: frier 
firers: friers 
fires: fries frise serif 
sifters: strifes 
fissure: fussier 
refits: rifest sifter strife 
fustier: surfeit 
fixer: refix 
fiery: reify 
fluent: unfelt 
flyover: overfly 
flower: reflow 
fluster: restful 
felts: lefts 
flues: fuels 
felt: left 
flue: fuel 
perform: preform 
performs: preforms 
former: reform 
formers: reforms 
foretop: poofter 
forrest: forster 
ferrous: furores 
forests: fosters 
forest: fortes foster softer 
ferry: freyr fryer refry 
refs: serf 
fret: reft 
frey: frye 
jiggering: rejigging 
gingkoes: ginkgoes 
leggin: niggle 
leggins: niggles 
wigglers: wriggles 
wiggler: wriggle 
reorging: rogering 
ginger: nigger 
gingers: gingers niggers snigger 
gesturing: grungiest 
gingery: greying 
gurgles: luggers slugger 
gurgle: lugger 
muggers: smugger 
grunges: snugger 
houselights: lighthouses 
eighths: heights highest 
eighth: height 
hirelings: relishing 
heisting: nighties thingies 
english: shingle 
lighters: relights slighter 
lighter: relight 
hemings: meshing 
hinge: neigh 
gershwin: whingers 
hinges: neighs 
shewing: whinges 
hewing: whinge 
ethology: theology 
hungover: overhung 
hunger: rehung 
ghent: thegn 
kinglier: ringlike 
enlisting: listening tinseling 
silvering: slivering 
reliving: reviling 
immersing: simmering 
premising: simpering 
meriting: mitering 
repining: ripening 
insigne: seining 
reprising: respiring springier 
persisting: springiest 
grittiness: stringiest 
ignite: tieing 
lemming: memling 
gloominess: neologisms 
gremlin: mingler 
oenologist: ontologies 
enologist: neologist 
lowering: roweling 
legions: lingoes 
lingers: slinger 
ringlets: sterling 
ringlet: tingler 
lessing: singles 
glistens: singlets 
gluiness: ugliness 
glisten: singlet tingles 
lettings: settling 
typologies: typologies 
glisters: gristles 
glister: gristle 
gluier: uglier 
gluiest: ugliest 
mentoring: remington 
impugners: presuming 
pigment: temping 
nitrogens: ringtones 
nitrogen: ringtone 
ensigns: sensing 
nesting: tensing 
ensuing: gunnies 
netting: tenting 
reposing: spongier 
ignore: region 
resorting: restoring 
ignores: regions 
erupting: reputing 
niger: reign 
erring: ringer 
restrings: stringers 
restring: stringer 
ingres: reigns resign signer singer 
ingress: resigns signers singers 
resting: stinger 
strewing: wresting 
serving: versing 
swinger: wingers 
gustiness: gutsiness 
ingests: signets 
ingest: signet tinges 
setting: testing 
stewing: twinges 
sewing: swinge 
groupie: pirogue 
goiters: goitres goriest 
goiter: goitre 
egoists: stogies 
egoist: stogie 
gustier: gutsier 
gustiest: gutsiest 
guises: gussie 
gel: leg 
golem: gomel 
gunsel: lunges 
loge: ogle 
loges: ogles 
gulpers: splurge 
gels: legs 
glues: luges 
glue: luge 
goner: negro 
regrown: wronger 
goners: negros 
groupers: regroups 
grouper: regroup 
ergo: goer gore ogre 
reorg: roger 
reorgs: rogers 
growers: regrows 
grower: regrow 
goers: gores gorse ogres 
gorses: ogress 
grouse: rogues rouges rugose 
ergot: roget 
rogue: rouge 
egos: goes 
purges: spurge 
erg: reg 
surge: urges 
grey: gyre 
guests: gusset 
eh: he 
philosophies: philosophise 
shittier: thirties 
rethinks: thinkers 
rethink: thinker 
hikers: shriek shrike 
shrieks: shrikes 
hikes: sheik 
sherrill: shriller 
holstein: hotlines 
holiest: hostile 
philters: philtres 
philter: philtre 
hitler: lither 
lettish: lithest thistle 
heroism: moreish 
ownerships: shipowners 
ownership: shipowner 
heroins: inshore 
shiner: shrine 
shiners: shrines 
sherwin: whiners 
hines: shine 
newish: whines 
horsiest: shorties 
hoister: shortie 
perish: reship 
heir: hire 
hurries: rushier 
heirs: hires shier shire 
shivers: shrives 
swisher: wishers 
hitters: tithers 
withers: writhes 
shiver: shrive 
hitter: tither 
whiter: wither writhe 
heists: shiest shites thesis 
heist: shite 
theist: tithes 
whites: withes 
white: withe 
honkers: kherson 
houseworks: workhouses 
housework: workhouse 
hells: shell 
portholes: potholers 
porthole: potholer 
posthole: potholes 
holsters: hostlers 
holster: hostler 
helots: hostel hotels tholes 
hovels: shovel 
helot: hotel thole 
holey: hoyle 
helps: shlep 
hustlers: ruthless 
hurtles: hustler 
hurtle: luther 
hustles: lushest sleuths 
hustle: sleuth 
hormone: moorhen 
hormones: moorhens 
mothers: smother thermos 
musher: rheums 
hems: mesh 
heron: honer horne rhone 
herons: honers nosher 
onrushes: unhorses 
hornets: shorten thrones 
hornet: throne 
hones: shone 
shewn: whens 
hewn: when 
orthoses: shooters soothers 
hooters: shooter soother 
hoppers: shopper 
pothers: strophe 
pother: thorpe 
hero: hoer 
heros: hoers horse shore 
horses: shores 
others: throes 
hovers: shover shrove 
reshow: shower whores 
hoes: hose shoe 
hoses: shoes 
ethos: those 
rhesus: rushes ushers 
hes: she 
hess: shes 
thews: whets 
hews: shew 
thew: whet 
thewy: wyeth 
milliliters: millilitres 
milliliter: millilitre 
impressionism: misimpression 
priorities: prioritise 
inkiness: skinnies 
kristine: stinkier 
missile: similes 
elitisms: slimiest 
elitism: limiest 
elision: lionise 
elisions: lionises oiliness 
elitists: siltiest 
mistimes: semitism 
impression: permission 
impressions: permissions permissions 
missioner: remission 
missioners: remissions 
interims: minister 
interim: mintier termini 
miriest: mistier 
tientsin: tinniest 
propitiousness: superpositions 
petitions: pointiest 
ioniser: ironies noisier 
piniest: tiepins 
joiner: rejoin 
joiners: rejoins 
kiel: like 
likens: silken 
welkins: winkles 
welkin: winkle 
liker: rilke 
kilter: kirtle 
irksome: smokier 
kine: nike 
stinker: tinkers 
knitters: trinkets 
reknit: tinker 
knitter: trinket 
kepi: pike 
kippers: skipper 
kepis: pikes spike 
kisser: skiers 
strike: trikes 
kites: tikes 
kite: tike 
eli: lei lie 
lentils: lintels 
lentil: lintel 
overspills: spillovers 
overspill: spillover 
stiller: tillers trellis 
ellis: lisle 
evilly: lively vilely 
emil: lime mile 
monopolies: monopolise 
limner: merlin 
minutely: untimely 
limper: prelim 
prelims: simpler 
lumpier: plumier 
impels: simple 
misspelt: simplest 
limpest: limpets 
lumpiest: plumiest 
limes: miles slime smile 
slimes: smiles 
messily: smileys 
limeys: smiley 
emily: limey 
lien: line neil nile 
lenin: linen 
lonnie: online 
insole: lesion 
insoles: lesions lioness 
lewiston: towlines 
elution: outline 
spinel: spline 
lineups: lupines 
lineup: lupine unpile 
liens: lines niles 
enlists: listens silents tinsels 
enlist: inlets listen silent tinsel 
livens: snivel 
elvin: liven nevil 
perviously: previously 
loire: oiler oriel 
lorises: rissole 
loiters: toilers 
loiter: toiler 
litotes: toilets 
olives: voiles 
olivet: violet 
olive: voile 
ripples: slipper 
stippler: tipplers 
stipple: tipples 
lisper: perils pliers 
splitter: triplets 
piles: plies spiel 
lire: riel rile 
riles: slier 
sultriest: surtitles 
silvers: slivers 
lister: liters litres tilers 
sluttier: surtitle 
livers: silver sliver 
liter: litre relit tiler 
litter: tilter 
liver: livre viler 
livery: verily 
isle: leis lies 
islets: sliest stiles 
islet: stile tiles 
livest: vilest 
evils: levis lives veils 
lewis: wiles 
lite: tile 
evil: levi live veil vile 
lwei: wile 
wiley: wylie 
immures: rummies 
mien: mine 
instrument: nutriments 
importunes: resumption 
nepotism: pimentos 
monies: monies simeon 
moisten: sentimo 
mersin: miners 
minsters: trimness 
minster: minters 
mervin: vermin 
miens: mines nimes 
mittens: smitten 
minuets: minutes 
minuet: minute 
primrose: promiser 
importers: misreport 
importer: reimport 
imposer: promise semipro 
imposers: promises semipros 
mortiser: stormier 
isomer: moires 
isomers: mossier 
moister: mortise 
timeouts: titmouse 
primes: simper 
impress: premiss simpers 
impurest: stumpier 
spumier: umpires 
impure: umpire 
impetus: imputes 
emir: meir mire rime 
emirs: mires miser reims rimes 
misers: remiss 
mussier: surmise 
merits: mister miters mitres remits smiter timers 
merit: miter mitre remit timer 
mixer: remix 
smites: tmesis 
emits: items metis mites smite times 
emit: item mite time 
ironstone: serotonin 
pension: pinones 
intones: tension 
sunnite: tunnies 
ennius: ennuis 
poisoner: snoopier 
pointers: proteins 
pointer: protein 
opines: ponies 
nepotists: pottiness 
ironer: renoir 
nosier: senior 
neurosis: resinous 
orients: stonier 
orient: tonier 
eosin: noise 
envious: niveous 
envoi: ovine 
pein: pine 
printers: reprints sprinter 
printer: reprint 
ripens: sniper 
punier: purine unripe 
penis: pines snipe spine 
snipes: spines 
insteps: spinets 
instep: spinet 
erin: rein 
reins: resin rinse risen siren 
resins: rinses sirens 
insures: sunrise 
insert: inters niters nitres sinter 
inverts: striven 
twiners: winters 
insure: inures urines ursine 
inert: inter niter nitre trine 
twiner: winter 
inure: urine 
insets: steins 
sinews: swines 
inset: nites stein tines 
unites: unties 
nevis: veins vines 
sinew: swine wines 
nite: tine 
unite: untie 
nevi: vein vine 
inez: zine 
sootiest: tootsies 
prosiest: ripostes 
riposte: ropiest 
pervious: previous viperous 
poises: posies 
potties: tiptoes 
resistor: roisters sorriest 
rioters: roister 
rosiest: sorties stories 
pei: pie 
stripper: trippers 
pipers: sipper 
equips: piques 
equip: pique 
pier: ripe 
prier: riper 
priers: sprier 
piers: pries prise spire 
pisser: prises spires 
esprits: persist priests spriest sprites stripes 
pussier: suspire 
esprit: priest ripest sprite stripe tripes 
pyrites: stripey 
pisses: sepsis 
pistes: spites 
piste: spite 
swipe: wipes 
quires: risque squire 
quiet: quite 
terri: trier 
ires: rise sire 
rises: sires 
resists: sisters 
resist: resits sister 
rustiest: trusties 
resit: rites tiers tires tries 
titters: tritest 
twister: witters 
rivets: strive verist 
wriest: writes 
weirs: wires wiser 
rite: tier tire 
rive: vier 
weir: wire 
sites: sties 
suites: tissue 
exists: sexist 
issue: susie 
site: ties 
exist: exits 
ives: vies vise 
views: wives 
view: wive 
jolters: jostler 
jest: jets 
elk: lek 
pokes: spoke 
reworks: workers 
rework: worker 
stokers: strokes 
stoker: stroke 
stoke: tokes 
keys: skye 
outsells: sellouts 
outsell: sellout 
lovely: volley 
ells: sell 
swell: wells 
lyle: yell 
elm: lem 
plummest: plummets 
lemon: melon 
lemnos: lemons melons solemn 
lumpen: plenum 
elmo: lome mole 
morels: morsel 
melos: moles mosel 
molest: motels 
myrtle: termly 
melts: smelt 
leon: lone noel 
enrol: loner loren 
enrols: loners 
novels: sloven 
elton: lento 
leo: ole 
looters: retools 
looter: retool 
loose: oleos 
lope: pole 
stopple: topples 
loper: poler prole 
lopes: poles slope 
lore: orel 
lores: loser roles 
lessor: losers 
ostler: sterol 
louvers: louvres velours 
lovers: solver 
lowers: rowels slower 
louver: louvre velour 
lower: rowel 
lose: oles sloe 
loess: loses 
lotuses: solutes tousles 
stole: toles 
solute: tousle 
lowest: owlets towels 
louse: seoul 
loves: solve voles 
vowels: wolves 
owlet: towel 
love: vole 
purples: suppler 
pluses: pulses 
pelts: slept spelt 
lepus: pules pulse 
lept: pelt 
lusters: lustres results rustles sutlers ulsters 
luster: lustre result rustle sutler ulster 
lures: rules 
lyres: slyer 
lure: rule 
lyre: rely ryle 
slyest: styles 
lest: lets 
welty: wetly 
em: me 
resummon: summoner 
memos: somme 
monotones: moonstone 
nome: omen 
mentors: monster 
mounters: remounts 
mentor: merton 
mounter: remount 
meson: omens 
moneys: moneys 
monet: monte 
munster: sternum 
moore: romeo 
morose: romeos 
mope: poem 
moper: proem 
mopes: poems 
more: rome 
mores: morse 
mouses: mousse 
motes: smote 
moues: mouse 
meou: moue 
perms: sperm 
strumpet: trumpets 
estrum: muster 
muser: remus serum sumer 
emus: muse 
en: ne 
neon: none 
neurons: nonuser 
neons: nones 
sonnet: tenons tonnes 
tenon: tonne 
punnets: unspent 
eon: one 
poorness: snoopers 
ozones: snooze 
nope: open peon pone 
peron: prone 
postern: preston pronest 
opens: peons pones 
nero: oren reno 
overturns: turnovers 
overturn: turnover 
norse: senor snore 
senors: sensor snores 
nestor: stoner tenors tensor toners toners 
owners: resown worsen 
tenor: toner 
enos: eons noes nose ones 
onsets: stenos stones 
notes: onset seton steno stone tones 
nosey: noyes 
note: tone 
enow: owen 
zeno: zone 
pruners: spurner 
punster: punters 
returns: turners 
nurser: reruns 
return: turner 
nurture: untruer 
ernst: rents stern terns 
entrust: nutters 
tuners: unrest 
nurse: runes 
rent: tern 
ens: sen 
nest: nets sent tens 
netts: stent tents 
nevus: venus 
news: sewn wens 
net: ten 
nett: tent 
newt: went 
new: wen 
oppressor: proposers 
opposer: propose 
rooster: rooters 
rooter: torero 
ope: poe 
propers: prosper 
stopper: toppers 
pore: rope 
porters: presort reports 
posturer: troupers 
porter: report 
pores: poser prose ropes spore 
posers: proses spores 
posters: prestos 
protests: spotters 
poster: presto 
potters: protest 
posture: pouters proteus spouter troupes 
perot: toper 
pouter: troupe 
opes: peso pose 
pesos: poses posse 
opuses: spouse 
estop: pesto poets 
expos: poxes 
poet: tope 
quoter: torque 
quotes: toques 
quote: toque 
ore: roe 
resorts: rosters sorters 
resort: retros roster sorter torres 
retorts: rotters 
routers: trouser 
rouser: sourer 
retort: rotter 
eros: ores roes rose sore 
roses: sores 
sorest: stores tosser 
estrous: oestrus ousters sourest 
oysters: storeys 
rouses: serous 
servos: versos 
resows: sowers worses 
rotes: store 
otters: tortes 
ouster: routes souter 
strove: troves voters 
oyster: storey 
euros: roues rouse 
overs: roves servo verso 
resow: sower swore worse 
rote: tore 
otter: torte 
outer: outre route 
overt: trove voter 
tower: wrote 
euro: roue 
over: rove 
stove: votes 
owes: woes 
veto: vote 
owe: woe 
supper: uppers 
per: rep 
pursuers: usurpers 
pursuer: usurper 
pryers: spryer 
perry: pryer 
purses: supers 
putters: sputter 
erupts: purest 
purse: super 
preys: pyres 
peru: pure 
prexy: pyrex 
prey: pyre 
pests: steps 
setups: upsets 
pest: pets step 
setup: upset 
pesty: types 
pews: spew 
espy: yeps 
er: re 
truster: turrets 
retry: terry 
russets: trusses 
rests: tress 
estrus: russet surest 
strews: wrests 
ruses: users 
erst: rest tres 
truest: utters 
suture: uterus 
strew: trews wrest 
treys: tyres 
rues: ruse suer sure user 
trey: tyre 
rye: yer 
setts: stets tests 
stews: wests 
sues: uses 
sett: stet test 
vest: vets 
stew: west wets 
sue: use 
suez: zeus 
griffin: riffing 
goniff: offing 
stiff: tiffs 
luffs: sluff 
flushing: lungfish 
finking: knifing 
flirting: trifling 
flowing: fowling wolfing 
fringy: frying 
flog: golf 
flogs: golfs 
firths: shrift 
forth: froth 
kinfolks: kinsfolk 
filo: foil 
flits: lifts 
flit: lift 
first: rifts 
fists: sifts 
fist: fits sift 
spoonfuls: spoonsful 
flows: fowls wolfs 
flow: fowl wolf 
form: from 
founts: futons 
fount: futon 
poofs: spoof 
for: fro 
forts: frost 
furs: surf 
loggings: slogging 
lightings: slighting 
singling: slinging 
glinting: tingling 
signing: singing 
signings: singings 
girting: ringgit 
gingko: ginkgo 
gingkos: ginkgos 
glossing: goslings 
goring: gringo 
hitting: tithing 
whiting: withing 
hustling: sunlight 
spotlights: stoplights 
spotlight: stoplight 
lights: slight 
gnomish: moshing 
onrushing: unhorsing 
huntings: shunting 
hooping: poohing 
shooting: soothing 
horsing: shoring 
hotting: tonight 
gunship: pushing 
nights: things 
night: thing 
nighty: thingy 
girths: rights 
girth: right 
gish: sigh 
ghouls: loughs slough 
ghoul: lough 
gunshots: shotguns 
gunshot: noughts shotgun 
gosh: hogs 
ghost: goths 
sought: toughs 
ought: tough 
gush: hugs 
hug: ugh 
inkling: kilning linking 
inklings: slinking 
kingpin: pinking 
skirting: striking 
kissing: skiings 
skiving: vikings 
lilting: tilling 
lignin: lining 
ligroin: roiling 
lisping: pilings 
listing: silting tilings 
tilting: titling tlingit 
miring: riming 
misting: smiting timings 
innings: sinning 
ironings: rosining 
printings: sprinting 
inuring: ruining 
origins: signori 
pipings: sipping 
rising: siring 
irving: riving virgin 
kingston: stonking 
lumping: pluming 
lingo: login 
looping: pooling 
loosing: soloing 
looting: tooling 
lingos: logins losing 
luring: ruling 
lings: sling 
lyings: singly 
gustily: gutsily 
mooring: rooming 
impugns: spuming 
impugn: umping 
musings: mussing 
gimpy: pigmy 
snooping: spooning 
noting: toning 
turnings: unstring 
stopping: toppings 
poring: roping 
posturing: sprouting 
postings: signpost 
groins: signor 
sorting: storing 
rousing: souring 
routing: touring 
ousting: outings 
pursuing: usurping 
grin: ring 
grins: rings 
truing: turing 
gins: sign sing 
signs: sings 
sting: tings 
suing: using 
swing: wings 
vigor: virgo 
gip: pig 
grip: prig 
grips: prigs sprig 
gris: rigs 
girts: grist grits trigs 
girt: grit trig 
gist: gits 
swig: wigs 
lungs: slung 
gulps: plugs 
gulp: plug 
lugs: slug 
smogs: smogs 
gums: mugs smug 
gum: mug 
grown: wrong 
snog: song 
snogs: songs 
grunts: strung 
gnus: guns snug sung 
gnu: gun 
gorps: sprog 
gory: gyro orgy 
gouts: gusto 
got: tog 
grus: rugs 
gust: guts tugs 
gusty: gutsy 
gut: tug 
kinship: pinkish 
isthmi: mishit 
irtish: tishri 
hills: shill 
lowish: owlish 
humorist: thoriums 
hims: shim 
punish: unship 
hints: thins 
hint: thin 
hopi: ipoh 
outwith: without 
hip: phi 
hips: phis ship 
irtysh: shirty 
hist: hits shit this 
whist: whits 
whit: with 
hokum: khoum 
hooks: shook 
holst: sloth 
lush: shul 
homs: mosh ohms shmo 
hums: mush 
hon: noh 
horns: shorn 
norths: thorns 
north: thorn 
hons: nosh 
hunts: shunt 
ho: oh 
oho: ooh 
hoop: pooh 
hoops: poohs 
hotspots: potshots 
hotpots: hotspot potshot 
oohs: shoo soho 
shoots: sooths 
hoots: shoot sooth 
hops: posh shop 
throws: worths 
horus: hours 
roth: thor 
throw: worth wroth 
hos: ohs soh 
hosts: shots 
shouts: souths 
host: hots shot tosh 
shout: south thous 
hows: show 
hot: tho 
how: who 
thrust: truths 
hurt: ruth thru 
huts: shut thus tush 
kiwis: wikis 
kiwi: wiki 
imprints: misprint 
izmit: mitzi 
oppositions: oppositions 
kills: skill 
kiln: link 
kilns: links slink 
ilks: silk 
minks: minsk 
ink: kin 
ikon: oink 
ikons: oinks 
inks: sink skin 
sinks: skins 
knits: skint stink 
kips: skip spik 
skips: spiks 
irks: risk 
kiss: skis 
kits: skit 
pills: spill 
ills: sill 
lilts: still tills 
swill: wills 
silly: slily 
lilt: till 
limo: milo moil 
limos: moils 
mils: slim 
lino: lion loin 
lions: loins 
insult: sunlit 
unlit: until 
inly: liny 
pilots: pistol spoilt 
lori: roil 
loris: roils 
lois: oils silo soil soli 
silos: soils 
loti: toil 
pupils: slipup 
lips: lisp slip 
lisps: slips 
spilt: split 
lists: silts slits 
list: silt slit 
stilt: tilts 
silty: styli 
lit: til 
mutism: summit 
inmost: monist 
myosin: simony 
imports: tropism 
moist: omits 
miry: rimy 
ism: mis sim 
isms: miss sims 
mist: smit 
unions: unison 
portions: positron 
options: potions 
option: potion 
prions: prison 
pintos: piston pitons points 
pinto: piton point 
iron: orin 
irons: rosin 
intro: nitro 
ions: sion 
into: toni 
nip: pin 
prints: sprint 
nips: pins snip spin 
snips: spins 
input: putin 
quints: squint 
ins: sin 
nits: snit tins 
stint: tints 
tunis: units 
nit: tin 
isotropy: porosity 
outstrips: posturist 
piso: pois 
posit: topis 
quito: quoit 
riots: tiros torsi trios 
riot: tiro trio 
irrupts: stirrup 
spirt: strip trips 
pis: psi sip 
piss: psis sips 
pits: spit tips 
pit: tip 
quirts: squirt 
wrist: writs 
situs: suits 
its: sit tis 
titus: tutsi 
twist: twits 
wist: wits 
six: xis 
it: ti 
twi: wit 
journos: sojourn 
just: juts 
lookouts: outlooks 
lookout: outlook 
knows: wonks 
know: wonk 
spunks: spunks 
punks: spunk 
outworks: workouts 
outwork: workout 
kyoto: tokyo 
kurt: truk turk 
outpull: pullout 
stroll: trolls 
lumps: plums slump 
lump: plum 
lumpy: plumy 
lonny: nylon 
loon: nolo 
loons: solon 
lyons: sonly 
lyon: only 
loop: polo pool 
loops: polos pools sloop spool 
sloops: spools 
loos: oslo solo 
loots: stool 
lop: pol 
polyps: sloppy 
lops: pols slop 
ploys: polys 
pluto: poult 
ploy: poly 
lost: lots slot 
lotus: louts 
lows: owls slow 
low: owl 
purls: slurp 
lusts: sluts 
lust: slut 
mono: moon 
monos: moons 
morn: norm 
morns: norms 
mourn: munro 
mo: om 
moor: room 
moors: rooms 
mop: pom 
prom: romp 
proms: romps 
mops: poms 
most: mots toms 
sump: umps 
musts: smuts 
muss: sums 
must: smut tums 
mus: sum 
mu: um 
no: on 
pronto: proton 
snoop: spoon 
snoops: spoons 
sunspot: unstops 
pontus: unstop 
nor: ron 
nos: son 
snot: tons 
towns: wonts 
nous: onus 
nows: owns snow sown 
not: ton 
nowt: town wont 
now: own won 
puns: spun 
runts: turns 
runs: urns 
runt: turn 
run: urn 
nuts: stun tuns 
nus: sun 
nut: tun 
porto: troop 
oops: poos 
swoop: woops 
roosts: torsos 
roost: roots torso 
ouzos: ouzos 
otto: toot 
op: po 
sports: strops 
sprouts: stupors 
ports: sport strop 
proust: sprout stupor 
ops: sop 
poss: sops 
posts: spots stops 
spouts: stoups tossup 
opts: post pots spot stop tops 
outputs: putouts 
pouts: spout stoup 
opus: soup 
swop: wops 
opt: pot top 
output: putout 
pow: wop 
orts: rots sort tors 
torts: trots 
trouts: tutors 
roust: routs tours 
trows: worst worts 
story: tyros 
ours: sour 
ort: rot tor 
tort: trot 
trout: tutor 
rout: tour 
trow: wort 
tory: troy tyro 
sots: toss 
stouts: stouts 
stows: swots 
tost: tots 
stout: touts 
oust: outs 
stow: swot tows twos 
tow: two wot 
spurt: turps 
puss: sups 
pus: sup ups 
struts: trusts 
rusts: truss 
strut: trust 
rust: ruts 
rusty: yurts 
